Valuta,Kontotype,Type,Beløp,Saldo,Dato,Referanse,Beskrivelse
NOK,"Tilgjenglig for kjøp eller uttak",Rente,5.42,5.42,"2025-08-07 09:17:32","Konventveien 35 AS - 4713",Renteinntekt
NOK,"Tilgjenglig for kjøp eller uttak",Kjøp,-292.72,0,"2025-08-05 10:59:52","Stubbbengkroken 73 AS - 4865",Tegning
NOK,"Tilgjenglig for kjøp eller uttak",Rente,5.42,292.72,"2025-08-04 08:26:05","VE Gruppen - 4820",Renteinntekt
NOK,"Tilgjenglig for kjøp eller uttak",Rente,10,287.3,"2025-08-04 08:25:59","TBGEiendom AS - 4742",Renteinntekt
NOK,"Tilgjenglig for kjøp eller uttak",Rente,10,277.3,"2025-08-04 08:25:40","TBGEiendom AS - 4683",Renteinntekt
NOK,"Tilgjenglig for kjøp eller uttak",Rente,21.67,267.3,"2025-07-31 16:19:34","Streng AS - 4537",Renteinntekt
NOK,"Tilgjenglig for kjøp eller uttak",Rente,5.42,245.63,"2025-07-30 09:57:37","BM Prosjekt og Utvikling AS - 4701",Renteinntekt
NOK,"Tilgjenglig for kjøp eller uttak",Rente,5,240.21,"2025-07-30 09:57:32","BM Prosjekt og Utvikling AS - 4691",Renteinntekt
NOK,"Tilgjenglig for kjøp eller uttak",Rente,10.83,235.21,"2025-07-29 12:49:34","Torggata 5 Skien AS - 4749",Renteinntekt
NOK,"Tilgjenglig for kjøp eller uttak",Rente,10.83,224.38,"2025-07-29 12:49:22","Torggata 5 Skien AS - 4727",Renteinntekt
NOK,"Tilgjenglig for kjøp eller uttak",Rente,10.83,213.55,"2025-07-29 12:48:59","Torggata 5 Skien AS - 4709",Renteinntekt
NOK,"Tilgjenglig for kjøp eller uttak",Rente,5.42,202.72,"2025-07-28 15:17:06","Atlas Eiendom AS - 4830",Renteinntekt
NOK,"Tilgjenglig for kjøp eller uttak",Rente,5.42,197.3,"2025-07-28 15:17:01","Atlas Eiendom AS - 4659",Renteinntekt
NOK,"Tilgjenglig for kjøp eller uttak",Rente,5.42,191.88,"2025-07-28 15:16:51","Atlas Eiendom AS - 4637",Renteinntekt
NOK,"Tilgjenglig for kjøp eller uttak",Rente,23.33,186.46,"2025-07-28 15:16:18","Atlas Eiendom AS - 4541",Renteinntekt
NOK,"Tilgjenglig for kjøp eller uttak",Rente,23.33,163.13,"2025-07-28 15:16:14","Atlas Eiendom AS - 4526",Renteinntekt
NOK,"Tilgjenglig for kjøp eller uttak",Rente,23.33,139.8,"2025-07-28 15:16:06","Atlas Eiendom AS - 4510",Renteinntekt
NOK,"Tilgjenglig for kjøp eller uttak",Rente,21.67,116.47,"2025-07-28 08:33:38","AEKO Eiendomsutvikling AS - 4501",Renteinntekt
NOK,"Tilgjenglig for kjøp eller uttak",Rente,15,94.8,"2025-07-28 08:33:24","Accrington AS  - 4726",Renteinntekt
NOK,"Tilgjenglig for kjøp eller uttak",Rente,20,79.8,"2025-07-28 08:33:16","Accrington AS  - 4649",Renteinntekt
NOK,"Tilgjenglig for kjøp eller uttak",Rente,15.62,59.8,"2025-07-22 19:00:59","EFA Eiendom AS - 4711",Renteinntekt
NOK,"Tilgjenglig for kjøp eller uttak",Rente,21.67,44.18,"2025-07-22 19:00:37","EFA Eiendom AS - 4628",Renteinntekt
NOK,"Tilgjenglig for kjøp eller uttak",Rente,22.5,22.51,"2025-07-22 19:00:18","EFA Eiendom AS - 4451",Renteinntekt
NOK,"Tilgjenglig for kjøp eller uttak",Innskudd,0.01,0.01,"2025-07-22 18:18:05","Stubbbengkroken 73 AS - 4846","Overskytende beløp ved innskudd av tegnet beløp"
NOK,"Tilgjenglig for kjøp eller uttak",Kjøp,-255.01,0,"2025-07-22 12:55:54","Stubbbengkroken 73 AS - 4846",Tegning
NOK,"Tilgjenglig for kjøp eller uttak",Rente,27.08,255.01,"2025-07-22 10:00:37","Bjerget 33 Eiendom AS  - 4710",Renteinntekt
NOK,"Tilgjenglig for kjøp eller uttak",Rente,10,227.93,"2025-07-18 09:30:45","Palmeglass AS - 4760",Renteinntekt
NOK,"Tilgjenglig for kjøp eller uttak",Rente,40,217.93,"2025-07-18 09:30:22","Palmeglass AS - 4730",Renteinntekt
NOK,"Tilgjenglig for kjøp eller uttak",Rente,5.21,177.93,"2025-07-14 08:57:34","Habitat Bolig AS - 4721",Renteinntekt
NOK,"Tilgjenglig for kjøp eller uttak",Rente,26.04,172.72,"2025-07-14 08:57:15","Habitat Bolig AS - 4702",Renteinntekt
NOK,"Tilgjenglig for kjøp eller uttak",Rente,5.21,146.68,"2025-07-14 08:57:00","Habitat Bolig AS - 4684",Renteinntekt
NOK,"Tilgjenglig for kjøp eller uttak",Rente,10.42,141.47,"2025-07-14 08:56:52","Habitat Bolig AS - 4665",Renteinntekt
NOK,"Tilgjenglig for kjøp eller uttak",Rente,5.15,131.05,"2025-07-11 11:56:33","BFM 8 AS - 4826",Renteinntekt
NOK,"Tilgjenglig for kjøp eller uttak",Rente,19.23,125.9,"2025-07-11 11:56:21","BFM 8 AS - 4809",Renteinntekt
NOK,"Tilgjenglig for kjøp eller uttak",Rente,11.67,106.67,"2025-07-11 11:56:02","BFM 8 AS - 4671",Renteinntekt
NOK,"Tilgjenglig for kjøp eller uttak",Rente,5.83,95,"2025-07-11 11:55:57","BFM 8 AS - 4656",Renteinntekt
NOK,"Tilgjenglig for kjøp eller uttak",Rente,29.17,89.17,"2025-07-11 11:55:51","BFM 8 AS - 4644",Renteinntekt
NOK,"Tilgjenglig for kjøp eller uttak",Rente,23.33,60,"2025-07-11 11:55:25","BFM 8 AS - 4481",Renteinntekt
NOK,"Tilgjenglig for kjøp eller uttak",Rente,11.67,36.67,"2025-07-10 14:26:28","Thorrud Bolig AS - 4651",Renteinntekt
NOK,"Tilgjenglig for kjøp eller uttak",Rente,25,25,"2025-07-10 08:19:52","Quadrat Eiendom AS - 4566",Renteinntekt
NOK,"Tilgjenglig for kjøp eller uttak",Kjøp,-46.96,0,"2025-07-07 09:12:28","Palmeglass AS - 4848",Tegning
NOK,"Tilgjenglig for kjøp eller uttak",Kjøp,-0.13,46.96,"2025-07-03 12:40:57","BFM 8 AS - 4844","Innskudd av tegnet beløp (fra tilgjengelig saldo)"
NOK,"Tilgjenglig for kjøp eller uttak",Rente,5.42,47.09,"2025-07-03 08:10:58","VE Gruppen - 4820",Renteinntekt
NOK,"Tilgjenglig for kjøp eller uttak",Rente,10,41.67,"2025-07-03 08:10:48","TBGEiendom AS - 4742",Renteinntekt
NOK,"Tilgjenglig for kjøp eller uttak",Rente,10,31.67,"2025-07-03 08:10:26","TBGEiendom AS - 4683",Renteinntekt
NOK,"Tilgjenglig for kjøp eller uttak",Rente,21.67,21.67,"2025-07-01 11:14:52","Streng AS - 4537",Renteinntekt
NOK,"Tilgjenglig for kjøp eller uttak",Kjøp,-44.87,0,"2025-07-01 09:17:34","BFM 8 AS - 4844",Tegning
NOK,"Tilgjenglig for kjøp eller uttak",Rente,5.42,44.87,"2025-06-30 09:44:51","BM Prosjekt og Utvikling AS - 4701",Renteinntekt
NOK,"Tilgjenglig for kjøp eller uttak",Rente,5,39.45,"2025-06-30 09:44:43","BM Prosjekt og Utvikling AS - 4691",Renteinntekt
NOK,"Tilgjenglig for kjøp eller uttak",Rente,10.83,34.45,"2025-06-30 09:44:00","Torggata 5 Skien AS - 4749",Renteinntekt
NOK,"Tilgjenglig for kjøp eller uttak",Rente,10.83,23.62,"2025-06-30 09:43:54","Torggata 5 Skien AS - 4727",Renteinntekt
NOK,"Tilgjenglig for kjøp eller uttak",Rente,10.83,12.79,"2025-06-30 09:43:30","Torggata 5 Skien AS - 4709",Renteinntekt
NOK,"Tilgjenglig for kjøp eller uttak",Innskudd,1.96,1.96,"2025-06-30 08:39:37","Konventveien 35 AS - 4713","Overskytende beløp ved innskudd av tegnet beløp"
NOK,"Tilgjenglig for kjøp eller uttak",Kjøp,-321.96,0,"2025-06-27 13:23:08","Konventveien 35 AS - 4713",Tegning
NOK,"Tilgjenglig for kjøp eller uttak",Rente,0.71,321.96,"2025-06-27 09:15:50","Atlas Eiendom AS - 4830",Renteinntekt
NOK,"Tilgjenglig for kjøp eller uttak",Rente,5.42,321.25,"2025-06-27 09:15:44","Atlas Eiendom AS - 4659",Renteinntekt
NOK,"Tilgjenglig for kjøp eller uttak",Rente,5.42,315.83,"2025-06-27 09:15:34","Atlas Eiendom AS - 4637",Renteinntekt
NOK,"Tilgjenglig for kjøp eller uttak",Rente,23.33,310.41,"2025-06-27 09:15:00","Atlas Eiendom AS - 4541",Renteinntekt
NOK,"Tilgjenglig for kjøp eller uttak",Rente,23.33,287.08,"2025-06-27 09:14:53","Atlas Eiendom AS - 4526",Renteinntekt
NOK,"Tilgjenglig for kjøp eller uttak",Rente,23.33,263.75,"2025-06-27 09:14:49","Atlas Eiendom AS - 4510",Renteinntekt
NOK,"Tilgjenglig for kjøp eller uttak",Rente,21.67,240.42,"2025-06-27 08:53:11","AEKO Eiendomsutvikling AS - 4501",Renteinntekt
NOK,"Tilgjenglig for kjøp eller uttak",Rente,15,218.75,"2025-06-26 09:11:41","Accrington AS  - 4726",Renteinntekt
NOK,"Tilgjenglig for kjøp eller uttak",Rente,20,203.75,"2025-06-26 09:11:29","Accrington AS  - 4649",Renteinntekt
NOK,"Tilgjenglig for kjøp eller uttak",Rente,15.62,183.75,"2025-06-23 08:57:36","EFA Eiendom AS - 4711",Renteinntekt
NOK,"Tilgjenglig for kjøp eller uttak",Rente,21.67,168.13,"2025-06-23 08:57:20","EFA Eiendom AS - 4628",Renteinntekt
NOK,"Tilgjenglig for kjøp eller uttak",Rente,22.5,146.46,"2025-06-23 08:56:45","EFA Eiendom AS - 4451",Renteinntekt
NOK,"Tilgjenglig for kjøp eller uttak",Rente,27.08,123.96,"2025-06-23 08:55:12","Bjerget 33 Eiendom AS  - 4710",Renteinntekt
NOK,"Tilgjenglig for kjøp eller uttak",Rente,10,96.88,"2025-06-18 09:09:13","Palmeglass AS - 4760",Renteinntekt
NOK,"Tilgjenglig for kjøp eller uttak",Rente,40,86.88,"2025-06-18 09:08:54","Palmeglass AS - 4730",Renteinntekt
NOK,"Tilgjenglig for kjøp eller uttak",Rente,5.21,46.88,"2025-06-16 08:30:58","Habitat Bolig AS - 4721",Renteinntekt
NOK,"Tilgjenglig for kjøp eller uttak",Rente,26.04,41.67,"2025-06-16 08:30:33","Habitat Bolig AS - 4702",Renteinntekt
NOK,"Tilgjenglig for kjøp eller uttak",Rente,5.21,15.63,"2025-06-16 08:30:25","Habitat Bolig AS - 4684",Renteinntekt
NOK,"Tilgjenglig for kjøp eller uttak",Rente,10.42,10.42,"2025-06-16 08:30:11","Habitat Bolig AS - 4665",Renteinntekt
NOK,"Tilgjenglig for kjøp eller uttak",Kjøp,-212.1,0,"2025-06-11 09:48:19","Atlas Eiendom AS - 4830",Tegning
NOK,"Tilgjenglig for kjøp eller uttak",Rente,11.67,212.1,"2025-06-10 08:50:52","Thorrud Bolig AS - 4651",Renteinntekt
NOK,"Tilgjenglig for kjøp eller uttak",Rente,25,200.43,"2025-06-10 08:50:44","Quadrat Eiendom AS - 4566",Renteinntekt
NOK,"Tilgjenglig for kjøp eller uttak",Rente,11.67,175.43,"2025-06-10 08:49:42","BFM 8 AS - 4671",Renteinntekt
NOK,"Tilgjenglig for kjøp eller uttak",Rente,5.83,163.76,"2025-06-10 08:49:32","BFM 8 AS - 4656",Renteinntekt
NOK,"Tilgjenglig for kjøp eller uttak",Rente,29.17,157.93,"2025-06-10 08:49:29","BFM 8 AS - 4644",Renteinntekt
NOK,"Tilgjenglig for kjøp eller uttak",Rente,23.33,128.76,"2025-06-10 08:49:14","BFM 8 AS - 4481",Renteinntekt
NOK,"Tilgjenglig for kjøp eller uttak",Rente,26.67,105.43,"2025-06-10 08:46:53","Kvitsand Hytter AS - 4516",Renteinntekt
NOK,"Tilgjenglig for kjøp eller uttak",Rente,26.67,78.76,"2025-06-10 08:46:47","Kvitsand Hytter AS - 4482",Renteinntekt
NOK,"Tilgjenglig for kjøp eller uttak",Rente,10,52.09,"2025-06-03 08:30:51","TBGEiendom AS - 4742",Renteinntekt
NOK,"Tilgjenglig for kjøp eller uttak",Rente,10,42.09,"2025-06-03 08:30:33","TBGEiendom AS - 4683",Renteinntekt
NOK,"Tilgjenglig for kjøp eller uttak",Rente,21.67,32.09,"2025-06-02 08:17:37","Streng AS - 4537",Renteinntekt
NOK,"Tilgjenglig for kjøp eller uttak",Rente,5.42,10.42,"2025-05-30 09:22:10","BM Prosjekt og Utvikling AS - 4701",Renteinntekt
NOK,"Tilgjenglig for kjøp eller uttak",Rente,5,5,"2025-05-30 09:22:02","BM Prosjekt og Utvikling AS - 4691",Renteinntekt
NOK,"Tilgjenglig for kjøp eller uttak",Kjøp,-169.99,0,"2025-05-28 09:36:37","BFM 8 AS - 4826",Tegning
NOK,"Tilgjenglig for kjøp eller uttak",Rente,5.42,169.99,"2025-05-28 08:51:45","Atlas Eiendom AS - 4659",Renteinntekt
NOK,"Tilgjenglig for kjøp eller uttak",Rente,5.42,164.57,"2025-05-28 08:51:40","Atlas Eiendom AS - 4637",Renteinntekt
NOK,"Tilgjenglig for kjøp eller uttak",Rente,23.33,159.15,"2025-05-28 08:51:15","Atlas Eiendom AS - 4541",Renteinntekt
NOK,"Tilgjenglig for kjøp eller uttak",Rente,23.33,135.82,"2025-05-28 08:51:12","Atlas Eiendom AS - 4526",Renteinntekt
NOK,"Tilgjenglig for kjøp eller uttak",Rente,23.33,112.49,"2025-05-28 08:51:05","Atlas Eiendom AS - 4510",Renteinntekt
NOK,"Tilgjenglig for kjøp eller uttak",Rente,10.83,89.16,"2025-05-28 08:49:20","Torggata 5 Skien AS - 4709",Renteinntekt
NOK,"Tilgjenglig for kjøp eller uttak",Rente,10.83,78.33,"2025-05-28 08:49:03","Torggata 5 Skien AS - 4727",Renteinntekt
NOK,"Tilgjenglig for kjøp eller uttak",Rente,10.83,67.5,"2025-05-28 08:48:55","Torggata 5 Skien AS - 4749",Renteinntekt
NOK,"Tilgjenglig for kjøp eller uttak",Rente,21.67,56.67,"2025-05-27 08:45:58","AEKO Eiendomsutvikling AS - 4501",Renteinntekt
NOK,"Tilgjenglig for kjøp eller uttak",Rente,15,35,"2025-05-26 15:38:46","Accrington AS  - 4726",Renteinntekt
NOK,"Tilgjenglig for kjøp eller uttak",Rente,20,20,"2025-05-26 15:38:38","Accrington AS  - 4649",Renteinntekt
NOK,"Tilgjenglig for kjøp eller uttak",Kjøp,-303.28,0,"2025-05-26 09:18:54","VE Gruppen - 4820",Tegning
NOK,"Tilgjenglig for kjøp eller uttak",Rente,27.08,303.28,"2025-05-23 09:04:47","Bjerget 33 Eiendom AS  - 4710",Renteinntekt
NOK,"Tilgjenglig for kjøp eller uttak",Rente,22.5,276.2,"2025-05-22 08:51:43","EFA Eiendom AS - 4451",Renteinntekt
NOK,"Tilgjenglig for kjøp eller uttak",Rente,21.67,253.7,"2025-05-22 08:51:18","EFA Eiendom AS - 4628",Renteinntekt
NOK,"Tilgjenglig for kjøp eller uttak",Rente,15.62,232.03,"2025-05-22 08:51:01","EFA Eiendom AS - 4711",Renteinntekt
NOK,"Tilgjenglig for kjøp eller uttak",Rente,40,216.41,"2025-05-19 09:34:32","Palmeglass AS - 4730",Renteinntekt
NOK,"Tilgjenglig for kjøp eller uttak",Rente,10,176.41,"2025-05-19 09:32:58","Palmeglass AS - 4760",Renteinntekt
NOK,"Tilgjenglig for kjøp eller uttak",Rente,5.21,166.41,"2025-05-14 14:34:19","Habitat Bolig AS - 4721",Renteinntekt
NOK,"Tilgjenglig for kjøp eller uttak",Rente,26.04,161.2,"2025-05-14 14:34:01","Habitat Bolig AS - 4702",Renteinntekt
NOK,"Tilgjenglig for kjøp eller uttak",Rente,5.21,135.16,"2025-05-14 14:33:47","Habitat Bolig AS - 4684",Renteinntekt
NOK,"Tilgjenglig for kjøp eller uttak",Rente,10.42,129.95,"2025-05-14 14:33:38","Habitat Bolig AS - 4665",Renteinntekt
NOK,"Tilgjenglig for kjøp eller uttak",Rente,11.67,119.53,"2025-05-12 08:25:12","Thorrud Bolig AS - 4651",Renteinntekt
NOK,"Tilgjenglig for kjøp eller uttak",Rente,25,107.86,"2025-05-12 08:25:04","Quadrat Eiendom AS - 4566",Renteinntekt
NOK,"Tilgjenglig for kjøp eller uttak",Rente,11.67,82.86,"2025-05-12 08:24:48","BFM 8 AS - 4671",Renteinntekt
NOK,"Tilgjenglig for kjøp eller uttak",Rente,5.83,71.19,"2025-05-12 08:24:39","BFM 8 AS - 4656",Renteinntekt
NOK,"Tilgjenglig for kjøp eller uttak",Rente,29.17,65.36,"2025-05-12 08:24:36","BFM 8 AS - 4644",Renteinntekt
NOK,"Tilgjenglig for kjøp eller uttak",Rente,23.33,36.19,"2025-05-12 08:24:25","BFM 8 AS - 4481",Renteinntekt
NOK,"Tilgjenglig for kjøp eller uttak",Kjøp,-1000,12.86,"2025-05-08 13:15:36","BFM 8 AS - 4809",Tegning
NOK,"Tilgjenglig for kjøp eller uttak",Rente,26.67,1012.86,"2025-05-07 08:19:29","Kvitsand Hytter AS - 4516",Renteinntekt
NOK,"Tilgjenglig for kjøp eller uttak",Rente,26.67,986.19,"2025-05-07 08:19:25","Kvitsand Hytter AS - 4482",Renteinntekt
NOK,"Tilgjenglig for kjøp eller uttak",Rente,10,959.52,"2025-05-05 08:22:35","TBGEiendom AS - 4742",Renteinntekt
NOK,"Tilgjenglig for kjøp eller uttak",Rente,10,949.52,"2025-05-05 08:22:25","TBGEiendom AS - 4683",Renteinntekt
NOK,"Tilgjenglig for kjøp eller uttak",Rente,21.67,939.52,"2025-05-02 07:19:59","Streng AS - 4537",Renteinntekt
NOK,"Tilgjenglig for kjøp eller uttak",Rente,5.42,917.85,"2025-04-30 09:15:22","BM Prosjekt og Utvikling AS - 4701",Renteinntekt
NOK,"Tilgjenglig for kjøp eller uttak",Rente,5,912.43,"2025-04-30 09:15:15","BM Prosjekt og Utvikling AS - 4691",Renteinntekt
NOK,"Tilgjenglig for kjøp eller uttak",Rente,10.83,907.43,"2025-04-28 09:45:49","Torggata 5 Skien AS - 4749",Renteinntekt
NOK,"Tilgjenglig for kjøp eller uttak",Rente,9.83,896.6,"2025-04-28 09:45:40","Torggata 5 Skien AS - 4727",Renteinntekt
NOK,"Tilgjenglig for kjøp eller uttak",Rente,10.83,886.77,"2025-04-28 09:45:30","Torggata 5 Skien AS - 4709",Renteinntekt
NOK,"Tilgjenglig for kjøp eller uttak",Rente,5.42,875.94,"2025-04-28 09:43:52","Atlas Eiendom AS - 4659",Renteinntekt
NOK,"Tilgjenglig for kjøp eller uttak",Rente,5.42,870.52,"2025-04-28 09:43:48","Atlas Eiendom AS - 4637",Renteinntekt
NOK,"Tilgjenglig for kjøp eller uttak",Rente,23.33,865.1,"2025-04-28 09:43:26","Atlas Eiendom AS - 4541",Renteinntekt
NOK,"Tilgjenglig for kjøp eller uttak",Rente,23.33,841.77,"2025-04-28 09:43:24","Atlas Eiendom AS - 4526",Renteinntekt
NOK,"Tilgjenglig for kjøp eller uttak",Rente,23.33,818.44,"2025-04-28 09:43:18","Atlas Eiendom AS - 4510",Renteinntekt
NOK,"Tilgjenglig for kjøp eller uttak",Rente,21.67,795.11,"2025-04-28 09:41:40","AEKO Eiendomsutvikling AS - 4501",Renteinntekt
NOK,"Tilgjenglig for kjøp eller uttak",Rente,15,773.44,"2025-04-28 09:41:03","Accrington AS  - 4726",Renteinntekt
NOK,"Tilgjenglig for kjøp eller uttak",Rente,20,758.44,"2025-04-28 09:40:57","Accrington AS  - 4649",Renteinntekt
NOK,"Tilgjenglig for kjøp eller uttak",Rente,27.08,738.44,"2025-04-23 09:07:20","Bjerget 33 Eiendom AS  - 4710",Renteinntekt
NOK,"Tilgjenglig for kjøp eller uttak",Rente,15.62,711.36,"2025-04-22 10:27:41","EFA Eiendom AS - 4711",Renteinntekt
NOK,"Tilgjenglig for kjøp eller uttak",Rente,21.67,695.74,"2025-04-22 10:27:29","EFA Eiendom AS - 4628",Renteinntekt
NOK,"Tilgjenglig for kjøp eller uttak",Rente,22.5,674.07,"2025-04-22 10:27:13","EFA Eiendom AS - 4451",Renteinntekt
NOK,"Tilgjenglig for kjøp eller uttak",Rente,8.2,651.57,"2025-04-22 10:18:47","Palmeglass AS - 4760",Renteinntekt
NOK,"Tilgjenglig for kjøp eller uttak",Rente,40,643.37,"2025-04-22 10:18:39","Palmeglass AS - 4730",Renteinntekt
NOK,"Tilgjenglig for kjøp eller uttak",Rente,11.67,603.37,"2025-04-16 06:55:05","Thorrud Bolig AS - 4651",Renteinntekt
NOK,"Tilgjenglig for kjøp eller uttak",Rente,5.21,591.7,"2025-04-15 14:17:03","Habitat Bolig AS - 4721",Renteinntekt
NOK,"Tilgjenglig for kjøp eller uttak",Rente,26.04,586.49,"2025-04-15 14:16:53","Habitat Bolig AS - 4702",Renteinntekt
NOK,"Tilgjenglig for kjøp eller uttak",Rente,5.21,560.45,"2025-04-15 14:16:41","Habitat Bolig AS - 4684",Renteinntekt
NOK,"Tilgjenglig for kjøp eller uttak",Rente,10.42,555.24,"2025-04-15 14:16:37","Habitat Bolig AS - 4665",Renteinntekt
NOK,"Tilgjenglig for kjøp eller uttak",Rente,25,544.82,"2025-04-10 09:04:06","Quadrat Eiendom AS - 4566",Renteinntekt
NOK,"Tilgjenglig for kjøp eller uttak",Rente,11.67,519.82,"2025-04-10 09:00:43","BFM 8 AS - 4671",Renteinntekt
NOK,"Tilgjenglig for kjøp eller uttak",Rente,5.83,508.15,"2025-04-10 09:00:34","BFM 8 AS - 4656",Renteinntekt
NOK,"Tilgjenglig for kjøp eller uttak",Rente,29.17,502.32,"2025-04-10 09:00:30","BFM 8 AS - 4644",Renteinntekt
NOK,"Tilgjenglig for kjøp eller uttak",Rente,23.33,473.15,"2025-04-10 09:00:18","BFM 8 AS - 4481",Renteinntekt
NOK,"Tilgjenglig for kjøp eller uttak",Rente,26.67,449.82,"2025-04-07 14:38:08","Kvitsand Hytter AS - 4516",Renteinntekt
NOK,"Tilgjenglig for kjøp eller uttak",Rente,26.67,423.15,"2025-04-07 14:38:05","Kvitsand Hytter AS - 4482",Renteinntekt
NOK,"Tilgjenglig for kjøp eller uttak",Rente,10,396.48,"2025-04-03 09:13:07","TBGEiendom AS - 4742",Renteinntekt
NOK,"Tilgjenglig for kjøp eller uttak",Rente,10,386.48,"2025-04-03 09:13:02","TBGEiendom AS - 4683",Renteinntekt
NOK,"Tilgjenglig for kjøp eller uttak",Rente,21.67,376.48,"2025-03-31 16:09:03","Streng AS - 4537",Renteinntekt
NOK,"Tilgjenglig for kjøp eller uttak",Rente,5.42,354.81,"2025-03-31 08:45:26","BM Prosjekt og Utvikling AS - 4701",Renteinntekt
NOK,"Tilgjenglig for kjøp eller uttak",Rente,5,349.39,"2025-03-31 08:45:23","BM Prosjekt og Utvikling AS - 4691",Renteinntekt
NOK,"Tilgjenglig for kjøp eller uttak",Rente,10.83,344.39,"2025-03-28 10:13:40","Torggata 5 Skien AS - 4749",Renteinntekt
NOK,"Tilgjenglig for kjøp eller uttak",Rente,11.4,333.56,"2025-03-28 10:13:33","Torggata 5 Skien AS - 4727",Renteinntekt
NOK,"Tilgjenglig for kjøp eller uttak",Rente,10.83,322.16,"2025-03-28 10:13:29","Torggata 5 Skien AS - 4709",Renteinntekt
NOK,"Tilgjenglig for kjøp eller uttak",Rente,5.42,311.33,"2025-03-28 10:10:13","Atlas Eiendom AS - 4659",Renteinntekt
NOK,"Tilgjenglig for kjøp eller uttak",Rente,5.42,305.91,"2025-03-28 10:10:09","Atlas Eiendom AS - 4637",Renteinntekt
NOK,"Tilgjenglig for kjøp eller uttak",Rente,23.33,300.49,"2025-03-28 10:09:50","Atlas Eiendom AS - 4541",Renteinntekt
NOK,"Tilgjenglig for kjøp eller uttak",Rente,23.33,277.16,"2025-03-28 10:09:47","Atlas Eiendom AS - 4526",Renteinntekt
NOK,"Tilgjenglig for kjøp eller uttak",Rente,23.33,253.83,"2025-03-28 10:09:43","Atlas Eiendom AS - 4510",Renteinntekt
NOK,"Tilgjenglig for kjøp eller uttak",Rente,21.67,230.5,"2025-03-27 09:03:20","AEKO Eiendomsutvikling AS - 4501",Renteinntekt
NOK,"Tilgjenglig for kjøp eller uttak",Rente,15,208.83,"2025-03-26 08:44:54","Accrington AS  - 4726",Renteinntekt
NOK,"Tilgjenglig for kjøp eller uttak",Rente,20,193.83,"2025-03-26 08:44:49","Accrington AS  - 4649",Renteinntekt
NOK,"Tilgjenglig for kjøp eller uttak",Rente,15.62,173.83,"2025-03-24 10:02:06","EFA Eiendom AS - 4711",Renteinntekt
NOK,"Tilgjenglig for kjøp eller uttak",Rente,27.08,158.21,"2025-03-24 10:02:03","Bjerget 33 Eiendom AS  - 4710",Renteinntekt
NOK,"Tilgjenglig for kjøp eller uttak",Rente,21.67,131.13,"2025-03-24 10:01:52","EFA Eiendom AS - 4628",Renteinntekt
NOK,"Tilgjenglig for kjøp eller uttak",Rente,22.5,109.46,"2025-03-24 10:01:33","EFA Eiendom AS - 4451",Renteinntekt
NOK,"Tilgjenglig for kjøp eller uttak",Rente,5.21,86.96,"2025-03-18 14:12:44","Habitat Bolig AS - 4721",Renteinntekt
NOK,"Tilgjenglig for kjøp eller uttak",Forsinkelsesrente,0.01,81.75,"2025-03-18 14:12:41","Habitat Bolig AS - 4721",Forsinkelsesrente
NOK,"Tilgjenglig for kjøp eller uttak",Rente,26.04,81.74,"2025-03-18 14:12:33","Habitat Bolig AS - 4702",Renteinntekt
NOK,"Tilgjenglig for kjøp eller uttak",Forsinkelsesrente,0.04,55.7,"2025-03-18 14:12:31","Habitat Bolig AS - 4702",Forsinkelsesrente
NOK,"Tilgjenglig for kjøp eller uttak",Rente,5.21,55.66,"2025-03-18 14:12:27","Habitat Bolig AS - 4684",Renteinntekt
NOK,"Tilgjenglig for kjøp eller uttak",Forsinkelsesrente,0.01,50.45,"2025-03-18 14:12:26","Habitat Bolig AS - 4684",Forsinkelsesrente
NOK,"Tilgjenglig for kjøp eller uttak",Rente,10.42,50.44,"2025-03-18 14:12:19","Habitat Bolig AS - 4665",Renteinntekt
NOK,"Tilgjenglig for kjøp eller uttak",Forsinkelsesrente,0.02,40.02,"2025-03-18 14:12:17","Habitat Bolig AS - 4665",Forsinkelsesrente
NOK,"Tilgjenglig for kjøp eller uttak",Rente,40,40,"2025-03-18 08:24:42","Palmeglass AS - 4730",Renteinntekt
NOK,"Tilgjenglig for kjøp eller uttak",Kjøp,-437.76,0,"2025-03-13 09:00:22","Palmeglass AS - 4760",Tegning
NOK,"Tilgjenglig for kjøp eller uttak",Rente,11.67,437.76,"2025-03-10 15:16:23","Thorrud Bolig AS - 4651",Renteinntekt
NOK,"Tilgjenglig for kjøp eller uttak",Rente,25,426.09,"2025-03-10 07:43:56","Quadrat Eiendom AS - 4566",Renteinntekt
NOK,"Tilgjenglig for kjøp eller uttak",Rente,11.67,401.09,"2025-03-10 07:43:03","BFM 8 AS - 4671",Renteinntekt
NOK,"Tilgjenglig for kjøp eller uttak",Rente,5.83,389.42,"2025-03-10 07:42:56","BFM 8 AS - 4656",Renteinntekt
NOK,"Tilgjenglig for kjøp eller uttak",Rente,29.17,383.59,"2025-03-10 07:42:53","BFM 8 AS - 4644",Renteinntekt
NOK,"Tilgjenglig for kjøp eller uttak",Rente,23.33,354.42,"2025-03-10 07:42:44","BFM 8 AS - 4481",Renteinntekt
NOK,"Tilgjenglig for kjøp eller uttak",Rente,26.67,331.09,"2025-03-07 08:19:45","Kvitsand Hytter AS - 4516",Renteinntekt
NOK,"Tilgjenglig for kjøp eller uttak",Rente,26.67,304.42,"2025-03-07 08:19:39","Kvitsand Hytter AS - 4482",Renteinntekt
NOK,"Tilgjenglig for kjøp eller uttak",Rente,5.42,277.75,"2025-03-03 14:47:39","BM Prosjekt og Utvikling AS - 4701",Renteinntekt
NOK,"Tilgjenglig for kjøp eller uttak",Rente,5,272.33,"2025-03-03 11:00:40","BM Prosjekt og Utvikling AS - 4691",Renteinntekt
NOK,"Tilgjenglig for kjøp eller uttak",Rente,3.93,267.33,"2025-03-03 08:47:36","TBGEiendom AS - 4742",Renteinntekt
NOK,"Tilgjenglig for kjøp eller uttak",Rente,10,263.4,"2025-03-03 08:47:30","TBGEiendom AS - 4683",Renteinntekt
NOK,"Tilgjenglig for kjøp eller uttak",Rente,21.67,253.4,"2025-03-03 08:47:11","Streng AS - 4537",Renteinntekt
NOK,"Tilgjenglig for kjøp eller uttak",Rente,8.6,231.73,"2025-03-03 08:47:08","Torggata 5 Skien AS - 4727",Renteinntekt
NOK,"Tilgjenglig for kjøp eller uttak",Rente,10.83,223.13,"2025-03-03 08:47:01","Torggata 5 Skien AS - 4709",Renteinntekt
NOK,"Tilgjenglig for kjøp eller uttak",Rente,5.42,212.3,"2025-02-28 09:20:53","Atlas Eiendom AS - 4659",Renteinntekt
NOK,"Tilgjenglig for kjøp eller uttak",Rente,5.42,206.88,"2025-02-28 09:20:48","Atlas Eiendom AS - 4637",Renteinntekt
NOK,"Tilgjenglig for kjøp eller uttak",Rente,23.33,201.46,"2025-02-28 09:20:30","Atlas Eiendom AS - 4541",Renteinntekt
NOK,"Tilgjenglig for kjøp eller uttak",Rente,23.33,178.13,"2025-02-28 09:20:27","Atlas Eiendom AS - 4526",Renteinntekt
NOK,"Tilgjenglig for kjøp eller uttak",Rente,23.33,154.8,"2025-02-28 09:20:25","Atlas Eiendom AS - 4510",Renteinntekt
NOK,"Tilgjenglig for kjøp eller uttak",Rente,21.67,131.47,"2025-02-27 07:36:41","AEKO Eiendomsutvikling AS - 4501",Renteinntekt
NOK,"Tilgjenglig for kjøp eller uttak",Rente,6.9,109.8,"2025-02-26 09:27:05","Accrington AS  - 4726",Renteinntekt
NOK,"Tilgjenglig for kjøp eller uttak",Rente,20,102.9,"2025-02-26 09:27:01","Accrington AS  - 4649",Renteinntekt
NOK,"Tilgjenglig for kjøp eller uttak",Rente,32.05,82.9,"2025-02-24 08:49:52","Bjerget 33 Eiendom AS  - 4710",Renteinntekt
NOK,"Tilgjenglig for kjøp eller uttak",Rente,22.5,50.85,"2025-02-24 08:48:54","EFA Eiendom AS - 4451",Renteinntekt
NOK,"Tilgjenglig for kjøp eller uttak",Rente,21.67,28.35,"2025-02-24 08:48:42","EFA Eiendom AS - 4628",Renteinntekt
NOK,"Tilgjenglig for kjøp eller uttak",Rente,6.68,6.68,"2025-02-24 08:48:32","EFA Eiendom AS - 4711",Renteinntekt
NOK,"Tilgjenglig for kjøp eller uttak",Kjøp,-45.94,0,"2025-02-19 09:32:58","Torggata 5 Skien AS - 4749",Tegning
NOK,"Tilgjenglig for kjøp eller uttak",Rente,5.21,45.94,"2025-02-17 10:02:33","Habitat Bolig AS - 4684",Renteinntekt
NOK,"Tilgjenglig for kjøp eller uttak",Rente,4.27,40.73,"2025-02-17 08:37:18","Habitat Bolig AS - 4721",Renteinntekt
NOK,"Tilgjenglig for kjøp eller uttak",Rente,26.04,36.46,"2025-02-17 08:37:15","Habitat Bolig AS - 4702",Renteinntekt
NOK,"Tilgjenglig for kjøp eller uttak",Rente,10.42,10.42,"2025-02-17 08:37:11","Habitat Bolig AS - 4665",Renteinntekt
NOK,"Tilgjenglig for kjøp eller uttak",Kjøp,-81.67,0,"2025-02-12 09:20:05","TBGEiendom AS - 4742",Tegning
NOK,"Tilgjenglig for kjøp eller uttak",Rente,11.67,81.67,"2025-02-11 15:01:22","Thorrud Bolig AS - 4651",Renteinntekt
NOK,"Tilgjenglig for kjøp eller uttak",Rente,11.67,70,"2025-02-11 15:00:58","BFM 8 AS - 4671",Renteinntekt
NOK,"Tilgjenglig for kjøp eller uttak",Rente,5.83,58.33,"2025-02-11 15:00:55","BFM 8 AS - 4656",Renteinntekt
NOK,"Tilgjenglig for kjøp eller uttak",Rente,29.17,52.5,"2025-02-11 15:00:51","BFM 8 AS - 4644",Renteinntekt
NOK,"Tilgjenglig for kjøp eller uttak",Rente,23.33,23.33,"2025-02-11 15:00:38","BFM 8 AS - 4481",Renteinntekt
NOK,"Tilgjenglig for kjøp eller uttak",Kjøp,-78.34,0,"2025-02-11 09:00:25","Palmeglass AS - 4730",Tegning
NOK,"Tilgjenglig for kjøp eller uttak",Rente,25,78.34,"2025-02-11 08:11:24","Quadrat Eiendom AS - 4566",Renteinntekt
NOK,"Tilgjenglig for kjøp eller uttak",Rente,26.67,53.34,"2025-02-07 09:56:37","Kvitsand Hytter AS - 4516",Renteinntekt
NOK,"Tilgjenglig for kjøp eller uttak",Rente,26.67,26.67,"2025-02-07 09:56:34","Kvitsand Hytter AS - 4482",Renteinntekt
NOK,"Tilgjenglig for kjøp eller uttak",Kjøp,-10,0,"2025-02-04 19:26:53","Accrington AS  - 4726",Tegning
NOK,"Tilgjenglig for kjøp eller uttak",Rente,10,10,"2025-02-03 11:30:46","TBGEiendom AS - 4683",Renteinntekt
NOK,"Tilgjenglig for kjøp eller uttak",Kjøp,-148.94,0,"2025-01-30 12:59:20","EFA Eiendom AS - 4711",Tegning
NOK,"Tilgjenglig for kjøp eller uttak",Rente,4.77,148.94,"2025-01-30 10:19:03","BM Prosjekt og Utvikling AS - 4691",Renteinntekt
NOK,"Tilgjenglig for kjøp eller uttak",Rente,21.67,144.17,"2025-01-30 09:20:43","Streng AS - 4537",Renteinntekt
NOK,"Tilgjenglig for kjøp eller uttak",Rente,5.42,122.5,"2025-01-28 08:09:26","Atlas Eiendom AS - 4659",Renteinntekt
NOK,"Tilgjenglig for kjøp eller uttak",Rente,5.42,117.08,"2025-01-28 08:09:23","Atlas Eiendom AS - 4637",Renteinntekt
NOK,"Tilgjenglig for kjøp eller uttak",Rente,23.33,111.66,"2025-01-28 08:09:07","Atlas Eiendom AS - 4541",Renteinntekt
NOK,"Tilgjenglig for kjøp eller uttak",Rente,23.33,88.33,"2025-01-28 08:09:05","Atlas Eiendom AS - 4526",Renteinntekt
NOK,"Tilgjenglig for kjøp eller uttak",Rente,23.33,65,"2025-01-28 08:09:01","Atlas Eiendom AS - 4510",Renteinntekt
NOK,"Tilgjenglig for kjøp eller uttak",Rente,20,41.67,"2025-01-27 08:44:02","Accrington AS  - 4649",Renteinntekt
NOK,"Tilgjenglig for kjøp eller uttak",Rente,21.67,21.67,"2025-01-27 08:41:48","AEKO Eiendomsutvikling AS - 4501",Renteinntekt
NOK,"Tilgjenglig for kjøp eller uttak",Kjøp,-44.17,0,"2025-01-24 09:29:30","Torggata 5 Skien AS - 4727",Tegning
NOK,"Tilgjenglig for kjøp eller uttak",Rente,21.67,44.17,"2025-01-22 08:12:34","EFA Eiendom AS - 4628",Renteinntekt
NOK,"Tilgjenglig for kjøp eller uttak",Rente,22.5,22.5,"2025-01-22 08:12:18","EFA Eiendom AS - 4451",Renteinntekt
NOK,"Tilgjenglig for kjøp eller uttak",Kjøp,-35.32,0,"2025-01-15 09:01:55","BM Prosjekt og Utvikling AS - 4701",Tegning
NOK,"Tilgjenglig for kjøp eller uttak",Rente,19.69,35.32,"2025-01-15 08:42:01","Habitat Bolig AS - 4702",Renteinntekt
NOK,"Tilgjenglig for kjøp eller uttak",Rente,5.21,15.63,"2025-01-15 08:41:57","Habitat Bolig AS - 4684",Renteinntekt
NOK,"Tilgjenglig for kjøp eller uttak",Rente,10.42,10.42,"2025-01-15 08:41:51","Habitat Bolig AS - 4665",Renteinntekt
NOK,"Tilgjenglig for kjøp eller uttak",Kjøp,-106.67,0,"2025-01-10 09:38:11","Habitat Bolig AS - 4721",Tegning
NOK,"Tilgjenglig for kjøp eller uttak",Rente,11.67,106.67,"2025-01-10 09:10:39","Thorrud Bolig AS - 4651",Renteinntekt
NOK,"Tilgjenglig for kjøp eller uttak",Rente,25,95,"2025-01-10 09:09:16","Quadrat Eiendom AS - 4566",Renteinntekt
NOK,"Tilgjenglig for kjøp eller uttak",Rente,11.67,70,"2025-01-10 09:08:56","BFM 8 AS - 4671",Renteinntekt
NOK,"Tilgjenglig for kjøp eller uttak",Rente,5.83,58.33,"2025-01-10 09:08:49","BFM 8 AS - 4656",Renteinntekt
NOK,"Tilgjenglig for kjøp eller uttak",Rente,29.17,52.5,"2025-01-10 09:08:47","BFM 8 AS - 4644",Renteinntekt
NOK,"Tilgjenglig for kjøp eller uttak",Rente,23.33,23.33,"2025-01-10 09:08:37","BFM 8 AS - 4481",Renteinntekt
NOK,"Tilgjenglig for kjøp eller uttak",Kjøp,-251.68,0,"2025-01-07 09:00:25","Bjerget 33 Eiendom AS  - 4710",Tegning
NOK,"Tilgjenglig for kjøp eller uttak",Rente,26.67,251.68,"2025-01-07 08:22:13","Kvitsand Hytter AS - 4516",Renteinntekt
NOK,"Tilgjenglig for kjøp eller uttak",Rente,26.67,225.01,"2025-01-07 08:22:08","Kvitsand Hytter AS - 4482",Renteinntekt
NOK,"Tilgjenglig for kjøp eller uttak",Rente,10,198.34,"2025-01-03 11:33:03","TBGEiendom AS - 4683",Renteinntekt
NOK,"Tilgjenglig for kjøp eller uttak",Rente,21.67,188.34,"2024-12-31 10:19:50","Streng AS - 4537",Renteinntekt
NOK,"Tilgjenglig for kjøp eller uttak",Rente,5.42,166.67,"2024-12-30 09:11:52","Atlas Eiendom AS - 4659",Renteinntekt
NOK,"Tilgjenglig for kjøp eller uttak",Rente,5.42,161.25,"2024-12-30 09:11:49","Atlas Eiendom AS - 4637",Renteinntekt
NOK,"Tilgjenglig for kjøp eller uttak",Rente,23.33,155.83,"2024-12-30 09:11:32","Atlas Eiendom AS - 4541",Renteinntekt
NOK,"Tilgjenglig for kjøp eller uttak",Rente,23.33,132.5,"2024-12-30 09:11:30","Atlas Eiendom AS - 4526",Renteinntekt
NOK,"Tilgjenglig for kjøp eller uttak",Rente,23.33,109.17,"2024-12-30 09:11:27","Atlas Eiendom AS - 4510",Renteinntekt
NOK,"Tilgjenglig for kjøp eller uttak",Rente,20,85.84,"2024-12-30 09:11:02","Accrington AS  - 4649",Renteinntekt
NOK,"Tilgjenglig for kjøp eller uttak",Rente,21.67,65.84,"2024-12-27 08:23:09","AEKO Eiendomsutvikling AS - 4501",Renteinntekt
NOK,"Tilgjenglig for kjøp eller uttak",Rente,21.67,44.17,"2024-12-23 10:22:13","EFA Eiendom AS - 4628",Renteinntekt
NOK,"Tilgjenglig for kjøp eller uttak",Rente,22.5,22.5,"2024-12-23 10:21:59","EFA Eiendom AS - 4451",Renteinntekt
NOK,"Tilgjenglig for kjøp eller uttak",Kjøp,-12.13,0,"2024-12-20 09:05:44","BM Prosjekt og Utvikling AS - 4691",Tegning
NOK,"Tilgjenglig for kjøp eller uttak",Rente,1.71,12.13,"2024-12-18 14:29:55","Habitat Bolig AS - 4684",Renteinntekt
NOK,"Tilgjenglig for kjøp eller uttak",Rente,10.42,10.42,"2024-12-18 14:29:49","Habitat Bolig AS - 4665",Renteinntekt
NOK,"Tilgjenglig for kjøp eller uttak",Kjøp,-304.03,0,"2024-12-12 09:00:59","Habitat Bolig AS - 4702",Tegning
NOK,"Tilgjenglig for kjøp eller uttak",Rente,11.67,304.03,"2024-12-12 08:04:46","Thorrud Bolig AS - 4651",Renteinntekt
NOK,"Tilgjenglig for kjøp eller uttak",Rente,25,292.36,"2024-12-10 08:50:30","Quadrat Eiendom AS - 4566",Renteinntekt
NOK,"Tilgjenglig for kjøp eller uttak",Rente,10.71,267.36,"2024-12-09 15:28:59","BFM 8 AS - 4671",Renteinntekt
NOK,"Tilgjenglig for kjøp eller uttak",Rente,5.83,256.65,"2024-12-09 15:28:53","BFM 8 AS - 4656",Renteinntekt
NOK,"Tilgjenglig for kjøp eller uttak",Rente,29.17,250.82,"2024-12-09 15:28:50","BFM 8 AS - 4644",Renteinntekt
NOK,"Tilgjenglig for kjøp eller uttak",Rente,23.33,221.65,"2024-12-09 15:28:38","BFM 8 AS - 4481",Renteinntekt
NOK,"Tilgjenglig for kjøp eller uttak",Rente,26.67,198.32,"2024-12-09 08:29:45","Kvitsand Hytter AS - 4516",Renteinntekt
NOK,"Tilgjenglig for kjøp eller uttak",Rente,26.67,171.65,"2024-12-09 08:29:42","Kvitsand Hytter AS - 4482",Renteinntekt
NOK,"Tilgjenglig for kjøp eller uttak",Rente,21.67,144.98,"2024-12-02 10:01:41","Streng AS - 4537",Renteinntekt
NOK,"Tilgjenglig for kjøp eller uttak",Rente,6.23,123.31,"2024-11-28 08:54:09","Atlas Eiendom AS - 4659",Renteinntekt
NOK,"Tilgjenglig for kjøp eller uttak",Rente,5.42,117.08,"2024-11-28 08:54:04","Atlas Eiendom AS - 4637",Renteinntekt
NOK,"Tilgjenglig for kjøp eller uttak",Rente,23.33,111.66,"2024-11-28 08:53:45","Atlas Eiendom AS - 4541",Renteinntekt
NOK,"Tilgjenglig for kjøp eller uttak",Rente,23.33,88.33,"2024-11-28 08:53:42","Atlas Eiendom AS - 4526",Renteinntekt
NOK,"Tilgjenglig for kjøp eller uttak",Rente,23.33,65,"2024-11-28 08:53:40","Atlas Eiendom AS - 4510",Renteinntekt
NOK,"Tilgjenglig for kjøp eller uttak",Rente,20,41.67,"2024-11-28 08:52:38","Accrington AS  - 4649",Renteinntekt
NOK,"Tilgjenglig for kjøp eller uttak",Rente,21.67,21.67,"2024-11-27 09:53:13","AEKO Eiendomsutvikling AS - 4501",Renteinntekt
NOK,"Tilgjenglig for kjøp eller uttak",Kjøp,-44.17,0,"2024-11-25 23:00:40","Habitat Bolig AS - 4684",Tegning
NOK,"Tilgjenglig for kjøp eller uttak",Rente,21.67,44.17,"2024-11-22 08:48:19","EFA Eiendom AS - 4628",Renteinntekt
NOK,"Tilgjenglig for kjøp eller uttak",Rente,22.5,22.5,"2024-11-22 08:48:05","EFA Eiendom AS - 4451",Renteinntekt
NOK,"Tilgjenglig for kjøp eller uttak",Kjøp,-340.62,0,"2024-11-20 09:06:17","TBGEiendom AS - 4683",Tegning
NOK,"Tilgjenglig for kjøp eller uttak",Rente,11.67,340.62,"2024-11-12 14:51:44","Thorrud Bolig AS - 4651",Renteinntekt
NOK,"Tilgjenglig for kjøp eller uttak",Rente,25,328.95,"2024-11-11 10:41:22","Quadrat Eiendom AS - 4566",Renteinntekt
NOK,"Tilgjenglig for kjøp eller uttak",Rente,3.25,303.95,"2024-11-11 10:41:04","BFM 8 AS - 4656",Renteinntekt
NOK,"Tilgjenglig for kjøp eller uttak",Rente,29.17,300.7,"2024-11-11 10:41:00","BFM 8 AS - 4644",Renteinntekt
NOK,"Tilgjenglig for kjøp eller uttak",Rente,23.33,271.53,"2024-11-11 10:40:48","BFM 8 AS - 4481",Renteinntekt
NOK,"Tilgjenglig for kjøp eller uttak",Rente,26.67,248.2,"2024-11-07 08:07:25","Kvitsand Hytter AS - 4516",Renteinntekt
NOK,"Tilgjenglig for kjøp eller uttak",Rente,26.67,221.53,"2024-11-07 08:07:20","Kvitsand Hytter AS - 4482",Renteinntekt
NOK,"Tilgjenglig for kjøp eller uttak",Kjøp,-1000,194.86,"2024-11-05 09:00:18","Habitat Bolig AS - 4665",Tegning
NOK,"Tilgjenglig for kjøp eller uttak",Kjøp,-1000,1194.86,"2024-10-30 09:14:12","BFM 8 AS - 4671",Tegning
NOK,"Tilgjenglig for kjøp eller uttak",Rente,21.67,2194.86,"2024-10-30 08:51:17","Streng AS - 4537",Renteinntekt
NOK,"Tilgjenglig for kjøp eller uttak",Rente,21.67,2173.19,"2024-10-28 08:35:00","AEKO Eiendomsutvikling AS - 4501",Renteinntekt
NOK,"Tilgjenglig for kjøp eller uttak",Rente,11.18,2151.52,"2024-10-28 08:34:46","Accrington AS  - 4649",Renteinntekt
NOK,"Tilgjenglig for kjøp eller uttak",Rente,5.52,2140.34,"2024-10-28 08:34:17","Atlas Eiendom AS - 4637",Renteinntekt
NOK,"Tilgjenglig for kjøp eller uttak",Rente,23.33,2134.82,"2024-10-28 08:34:00","Atlas Eiendom AS - 4541",Renteinntekt
NOK,"Tilgjenglig for kjøp eller uttak",Rente,23.33,2111.49,"2024-10-28 08:33:58","Atlas Eiendom AS - 4526",Renteinntekt
NOK,"Tilgjenglig for kjøp eller uttak",Rente,23.33,2088.16,"2024-10-28 08:33:54","Atlas Eiendom AS - 4510",Renteinntekt
NOK,"Tilgjenglig for kjøp eller uttak",Rente,21.67,2064.83,"2024-10-22 10:10:33","EFA Eiendom AS - 4628",Renteinntekt
NOK,"Tilgjenglig for kjøp eller uttak",Rente,22.5,2043.16,"2024-10-22 10:10:20","EFA Eiendom AS - 4451",Renteinntekt
NOK,"Tilgjenglig for kjøp eller uttak",Amortisering,2000,2020.66,"2024-10-22 08:58:08","EBH Entreprenør AS - 4599",Tilbakebetaling
NOK,"Tilgjenglig for kjøp eller uttak",Rente,20.66,20.66,"2024-10-22 08:58:06","EBH Entreprenør AS - 4599",Renteinntekt
NOK,"Tilgjenglig for kjøp eller uttak",Kjøp,-117.01,0,"2024-10-11 14:01:49","BFM 8 AS - 4656",Tegning
NOK,"Tilgjenglig for kjøp eller uttak",Rente,15.34,117.01,"2024-10-11 08:29:02","BFM 8 AS - 4644",Renteinntekt
NOK,"Tilgjenglig for kjøp eller uttak",Rente,25,101.67,"2024-10-10 08:52:25","Quadrat Eiendom AS - 4566",Renteinntekt
NOK,"Tilgjenglig for kjøp eller uttak",Rente,23.33,76.67,"2024-10-09 08:39:07","BFM 8 AS - 4481",Renteinntekt
NOK,"Tilgjenglig for kjøp eller uttak",Rente,26.67,53.34,"2024-10-07 08:55:57","Kvitsand Hytter AS - 4516",Renteinntekt
NOK,"Tilgjenglig for kjøp eller uttak",Rente,26.67,26.67,"2024-10-07 08:55:55","Kvitsand Hytter AS - 4482",Renteinntekt
NOK,"Tilgjenglig for kjøp eller uttak",Kjøp,-91.66,0,"2024-10-03 14:20:32","Thorrud Bolig AS - 4651",Tegning
NOK,"Tilgjenglig for kjøp eller uttak",Rente,21.67,91.66,"2024-10-01 09:18:00","Streng AS - 4537",Renteinntekt
NOK,"Tilgjenglig for kjøp eller uttak",Rente,23.33,69.99,"2024-09-30 08:56:18","Atlas Eiendom AS - 4541",Renteinntekt
NOK,"Tilgjenglig for kjøp eller uttak",Rente,23.33,46.66,"2024-09-30 08:56:15","Atlas Eiendom AS - 4526",Renteinntekt
NOK,"Tilgjenglig for kjøp eller uttak",Rente,23.33,23.33,"2024-09-30 08:56:13","Atlas Eiendom AS - 4510",Renteinntekt
NOK,"Tilgjenglig for kjøp eller uttak",Kjøp,-685.22,0,"2024-09-27 14:00:29","Accrington AS  - 4649",Tegning
NOK,"Tilgjenglig for kjøp eller uttak",Rente,21.67,685.22,"2024-09-27 08:58:16","AEKO Eiendomsutvikling AS - 4501",Renteinntekt
NOK,"Tilgjenglig for kjøp eller uttak",Rente,16.38,663.55,"2024-09-24 08:23:08","EFA Eiendom AS - 4628",Renteinntekt
NOK,"Tilgjenglig for kjøp eller uttak",Rente,22.5,647.17,"2024-09-24 08:22:55","EFA Eiendom AS - 4451",Renteinntekt
NOK,"Tilgjenglig for kjøp eller uttak",Rente,21.67,624.67,"2024-09-23 09:52:13","EBH Entreprenør AS - 4599",Renteinntekt
NOK,"Tilgjenglig for kjøp eller uttak",Innskudd,603,603,"2024-09-18 08:58:12",08017974326-362579343,Innskudd
NOK,"Tilgjenglig for kjøp eller uttak",Kjøp,-460.19,0,"2024-09-17 14:12:27","Atlas Eiendom AS - 4637",Tegning
NOK,"Tilgjenglig for kjøp eller uttak",Kjøp,-2500,460.19,"2024-09-13 14:00:21","BFM 8 AS - 4644",Tegning
NOK,"Tilgjenglig for kjøp eller uttak",Amortisering,2000,2960.19,"2024-09-12 16:51:59","Lager For Alle AS - 4483",Tilbakebetaling
NOK,"Tilgjenglig for kjøp eller uttak",Rente,16.44,960.19,"2024-09-12 16:51:56","Lager For Alle AS - 4483",Renteinntekt
NOK,"Tilgjenglig for kjøp eller uttak",Rente,25,943.75,"2024-09-10 09:14:28","Quadrat Eiendom AS - 4566",Renteinntekt
NOK,"Tilgjenglig for kjøp eller uttak",Rente,26.67,918.75,"2024-09-09 08:54:09","Kvitsand Hytter AS - 4516",Renteinntekt
NOK,"Tilgjenglig for kjøp eller uttak",Rente,26.67,892.08,"2024-09-09 08:54:04","Kvitsand Hytter AS - 4482",Renteinntekt
NOK,"Tilgjenglig for kjøp eller uttak",Rente,23.33,865.41,"2024-09-09 08:31:10","BFM 8 AS - 4481",Renteinntekt
NOK,"Tilgjenglig for kjøp eller uttak",Rente,21.67,842.08,"2024-08-30 09:08:26","Streng AS - 4537",Renteinntekt
NOK,"Tilgjenglig for kjøp eller uttak",Rente,23.33,820.41,"2024-08-28 08:55:27","Atlas Eiendom AS - 4541",Renteinntekt
NOK,"Tilgjenglig for kjøp eller uttak",Rente,23.33,797.08,"2024-08-28 08:55:25","Atlas Eiendom AS - 4526",Renteinntekt
NOK,"Tilgjenglig for kjøp eller uttak",Rente,23.33,773.75,"2024-08-28 08:55:22","Atlas Eiendom AS - 4510",Renteinntekt
NOK,"Tilgjenglig for kjøp eller uttak",Rente,21.67,750.42,"2024-08-27 09:15:32","AEKO Eiendomsutvikling AS - 4501",Renteinntekt
NOK,"Tilgjenglig for kjøp eller uttak",Rente,21.67,728.75,"2024-08-23 09:25:36","EBH Entreprenør AS - 4599",Renteinntekt
NOK,"Tilgjenglig for kjøp eller uttak",Rente,25,707.08,"2024-08-23 09:25:26","Lager For Alle AS - 4483",Renteinntekt
NOK,"Tilgjenglig for kjøp eller uttak",Rente,22.5,682.08,"2024-08-22 09:26:35","EFA Eiendom AS - 4451",Renteinntekt
NOK,"Tilgjenglig for kjøp eller uttak",Kjøp,-2000,659.58,"2024-08-21 14:34:00","EFA Eiendom AS - 4628",Tegning
NOK,"Tilgjenglig for kjøp eller uttak",Rente,19.73,2659.58,"2024-08-12 08:40:17","Quadrat Eiendom AS - 4566",Renteinntekt
NOK,"Tilgjenglig for kjøp eller uttak",Rente,23.33,2639.85,"2024-08-09 09:06:03","BFM 8 AS - 4481",Renteinntekt
NOK,"Tilgjenglig for kjøp eller uttak",Rente,26.67,2616.52,"2024-08-07 09:51:31","Kvitsand Hytter AS - 4516",Renteinntekt
NOK,"Tilgjenglig for kjøp eller uttak",Rente,26.67,2589.85,"2024-08-07 09:51:26","Kvitsand Hytter AS - 4482",Renteinntekt
NOK,"Tilgjenglig for kjøp eller uttak",Rente,21.67,2563.18,"2024-07-30 09:40:20","Streng AS - 4537",Renteinntekt
NOK,"Tilgjenglig for kjøp eller uttak",Rente,23.33,2541.51,"2024-07-29 09:15:16","Atlas Eiendom AS - 4541",Renteinntekt
NOK,"Tilgjenglig for kjøp eller uttak",Rente,23.33,2518.18,"2024-07-29 09:15:14","Atlas Eiendom AS - 4526",Renteinntekt
NOK,"Tilgjenglig for kjøp eller uttak",Rente,23.33,2494.85,"2024-07-29 09:15:10","Atlas Eiendom AS - 4510",Renteinntekt
NOK,"Tilgjenglig for kjøp eller uttak",Rente,21.67,2471.52,"2024-07-29 09:14:32","AEKO Eiendomsutvikling AS - 4501",Renteinntekt
NOK,"Tilgjenglig for kjøp eller uttak",Rente,10.68,2449.85,"2024-07-23 08:53:50","EBH Entreprenør AS - 4599",Renteinntekt
NOK,"Tilgjenglig for kjøp eller uttak",Rente,25,2439.17,"2024-07-23 08:53:40","Lager For Alle AS - 4483",Renteinntekt
NOK,"Tilgjenglig for kjøp eller uttak",Rente,22.5,2414.17,"2024-07-22 08:38:36","EFA Eiendom AS - 4451",Renteinntekt
NOK,"Tilgjenglig for kjøp eller uttak",Amortisering,2000,2391.67,"2024-07-10 10:00:50","LeilighetsExperten AS - 4592",Tilbakebetaling
NOK,"Tilgjenglig for kjøp eller uttak",Rente,77.5,391.67,"2024-07-10 10:00:43","LeilighetsExperten AS - 4592",Renteinntekt
NOK,"Tilgjenglig for kjøp eller uttak",Rente,23.33,314.17,"2024-07-09 09:45:54","BFM 8 AS - 4481",Renteinntekt
NOK,"Tilgjenglig for kjøp eller uttak",Rente,26.67,290.84,"2024-07-08 08:28:34","Kvitsand Hytter AS - 4516",Renteinntekt
NOK,"Tilgjenglig for kjøp eller uttak",Rente,26.67,264.17,"2024-07-08 08:28:31","Kvitsand Hytter AS - 4482",Renteinntekt
NOK,"Tilgjenglig for kjøp eller uttak",Rente,21.67,237.5,"2024-07-01 10:06:16","Streng AS - 4537",Renteinntekt
NOK,"Tilgjenglig for kjøp eller uttak",Rente,23.33,215.83,"2024-06-28 08:53:44","Atlas Eiendom AS - 4541",Renteinntekt
NOK,"Tilgjenglig for kjøp eller uttak",Rente,23.33,192.5,"2024-06-28 08:53:42","Atlas Eiendom AS - 4526",Renteinntekt
NOK,"Tilgjenglig for kjøp eller uttak",Rente,23.33,169.17,"2024-06-28 08:53:38","Atlas Eiendom AS - 4510",Renteinntekt
NOK,"Tilgjenglig for kjøp eller uttak",Rente,21.67,145.84,"2024-06-27 11:07:01","AEKO Eiendomsutvikling AS - 4501",Renteinntekt
NOK,"Tilgjenglig for kjøp eller uttak",Rente,25,124.17,"2024-06-24 09:34:46","Lager For Alle AS - 4483",Renteinntekt
NOK,"Tilgjenglig for kjøp eller uttak",Rente,22.5,99.17,"2024-06-24 08:57:38","EFA Eiendom AS - 4451",Renteinntekt
NOK,"Tilgjenglig for kjøp eller uttak",Rente,23.33,76.67,"2024-06-11 14:41:57","BFM 8 AS - 4481",Renteinntekt
NOK,"Tilgjenglig for kjøp eller uttak",Rente,26.67,53.34,"2024-06-07 08:00:01","Kvitsand Hytter AS - 4482",Renteinntekt
NOK,"Tilgjenglig for kjøp eller uttak",Rente,26.67,26.67,"2024-06-07 07:59:56","Kvitsand Hytter AS - 4516",Renteinntekt
NOK,"Tilgjenglig for kjøp eller uttak",Uttak,-240.25,0,"2024-06-06 10:40:24",,"Obligatorisk utbetaling av beløp på klientkonto"
NOK,"Tilgjenglig for kjøp eller uttak",Rente,21.67,240.25,"2024-05-30 15:25:34","Streng AS - 4537",Renteinntekt
NOK,"Tilgjenglig for kjøp eller uttak",Rente,26.08,218.58,"2024-05-28 11:21:37","Atlas Eiendom AS - 4541",Renteinntekt
NOK,"Tilgjenglig for kjøp eller uttak",Rente,23.33,192.5,"2024-05-28 11:21:33","Atlas Eiendom AS - 4526",Renteinntekt
NOK,"Tilgjenglig for kjøp eller uttak",Rente,23.33,169.17,"2024-05-28 11:21:30","Atlas Eiendom AS - 4510",Renteinntekt
NOK,"Tilgjenglig for kjøp eller uttak",Rente,21.67,145.84,"2024-05-27 09:46:16","AEKO Eiendomsutvikling AS - 4501",Renteinntekt
NOK,"Tilgjenglig for kjøp eller uttak",Rente,25,124.17,"2024-05-23 08:40:31","Lager For Alle AS - 4483",Renteinntekt
NOK,"Tilgjenglig for kjøp eller uttak",Rente,22.5,99.17,"2024-05-22 08:54:37","EFA Eiendom AS - 4451",Renteinntekt
NOK,"Tilgjenglig for kjøp eller uttak",Rente,23.33,76.67,"2024-05-10 09:08:09","BFM 8 AS - 4481",Renteinntekt
NOK,"Tilgjenglig for kjøp eller uttak",Rente,26.67,53.34,"2024-05-07 15:33:02","Kvitsand Hytter AS - 4516",Renteinntekt
NOK,"Tilgjenglig for kjøp eller uttak",Rente,26.67,26.67,"2024-05-07 15:32:58","Kvitsand Hytter AS - 4482",Renteinntekt
NOK,"Tilgjenglig for kjøp eller uttak",Uttak,-186.67,0,"2024-05-02 11:17:50",,"Obligatorisk utbetaling av beløp på klientkonto"
NOK,"Tilgjenglig for kjøp eller uttak",Rente,15.34,186.67,"2024-04-29 10:14:06","Atlas Eiendom AS - 4526",Renteinntekt
NOK,"Tilgjenglig for kjøp eller uttak",Rente,34.52,171.33,"2024-04-29 10:14:00","Atlas Eiendom AS - 4510",Renteinntekt
NOK,"Tilgjenglig for kjøp eller uttak",Rente,21.67,136.81,"2024-04-29 10:13:11","AEKO Eiendomsutvikling AS - 4501",Renteinntekt
NOK,"Tilgjenglig for kjøp eller uttak",Rente,22.5,115.14,"2024-04-23 14:21:38","EFA Eiendom AS - 4451",Renteinntekt
NOK,"Tilgjenglig for kjøp eller uttak",Rente,25,92.64,"2024-04-23 08:31:52","Lager For Alle AS - 4483",Renteinntekt
NOK,"Tilgjenglig for kjøp eller uttak",Kjøp,-2000,67.64,"2024-04-17 10:32:45","Streng AS - 4537",Tegning
NOK,"Tilgjenglig for kjøp eller uttak",Innskudd,2000,2067.64,"2024-04-17 08:51:22",08016911293-362569343,Innskudd
NOK,"Tilgjenglig for kjøp eller uttak",Rente,17.53,67.64,"2024-04-12 15:09:47","Kvitsand Hytter AS - 4516",Renteinntekt
NOK,"Tilgjenglig for kjøp eller uttak",Forsinkelsesrente,0.04,50.11,"2024-04-12 15:09:46","Kvitsand Hytter AS - 4516",Forsinkelsesrente
NOK,"Tilgjenglig for kjøp eller uttak",Rente,26.67,50.07,"2024-04-12 15:09:40","Kvitsand Hytter AS - 4482",Renteinntekt
NOK,"Tilgjenglig for kjøp eller uttak",Forsinkelsesrente,0.07,23.4,"2024-04-12 15:09:39","Kvitsand Hytter AS - 4482",Forsinkelsesrente
NOK,"Tilgjenglig for kjøp eller uttak",Kjøp,-2000,23.33,"2024-04-10 10:00:49","Atlas Eiendom AS - 4541",Tegning
NOK,"Tilgjenglig for kjøp eller uttak",Innskudd,2000,2023.33,"2024-04-10 09:04:28",08010109079-362599343,Innskudd
NOK,"Tilgjenglig for kjøp eller uttak",Rente,23.33,23.33,"2024-04-09 08:45:20","BFM 8 AS - 4481",Renteinntekt
NOK,"Tilgjenglig for kjøp eller uttak",Uttak,-2121.67,0,"2024-04-04 10:20:33",,"Obligatorisk udbetaling fra klientkonto"
NOK,"Tilgjenglig for kjøp eller uttak",Amortisering,2000,2121.67,"2024-03-27 15:47:24","G. Foss Eiendom AS - 4504",Tilbakebetaling
NOK,"Tilgjenglig for kjøp eller uttak",Rente,75,121.67,"2024-03-27 15:47:22","G. Foss Eiendom AS - 4504",Renteinntekt
NOK,"Tilgjenglig for kjøp eller uttak",Rente,21.67,46.67,"2024-03-27 10:26:34","AEKO Eiendomsutvikling AS - 4501",Renteinntekt
NOK,"Tilgjenglig for kjøp eller uttak",Rente,25,25,"2024-03-25 14:00:47","Lager For Alle AS - 4483",Renteinntekt
NOK,"Tilgjenglig for kjøp eller uttak",Kjøp,-2000,0,"2024-03-25 13:00:18","Atlas Eiendom AS - 4526",Tegning
NOK,"Tilgjenglig for kjøp eller uttak",Innskudd,2000,2000,"2024-03-22 10:14:08",08022109251-362519343,Innskudd
NOK,"Tilgjenglig for kjøp eller uttak",Uttak,-2000,0,"2024-03-21 10:42:14",,"Obligatorisk utbetalning av belopp på klientmedelskonto"
NOK,"Tilgjenglig for kjøp eller uttak",Innskudd,2000,2000,"2024-03-19 08:32:51",08019108107-362589343,Innskudd
NOK,"Tilgjenglig for kjøp eller uttak",Uttak,-54.89,0,"2024-03-14 10:08:38",,"Obligatorisk udbetaling fra klientkonto"
NOK,"Tilgjenglig for kjøp eller uttak",Rente,23.33,54.89,"2024-03-12 14:28:46","BFM 8 AS - 4481",Renteinntekt
NOK,"Tilgjenglig for kjøp eller uttak",Kjøp,-2000,31.56,"2024-03-08 14:03:18","EFA Eiendom AS - 4451",Tegning
NOK,"Tilgjenglig for kjøp eller uttak",Rente,31.56,2031.56,"2024-03-07 11:14:51","Kvitsand Hytter AS - 4482",Renteinntekt
NOK,"Tilgjenglig for kjøp eller uttak",Innskudd,2000,2000,"2024-03-07 11:11:54",08006108128-362559343,Innskudd
NOK,"Tilgjenglig for kjøp eller uttak",Kjøp,-2000,0,"2024-03-06 14:14:36","Kvitsand Hytter AS - 4516",Tegning
NOK,"Tilgjenglig for kjøp eller uttak",Innskudd,2000,2000,"2024-03-05 17:23:49",08004113277--D3,Innskudd
NOK,"Tilgjenglig for kjøp eller uttak",Kjøp,-2000,0,"2024-03-01 14:00:23","Atlas Eiendom AS - 4510",Tegning
NOK,"Tilgjenglig for kjøp eller uttak",Innskudd,2000,2000,"2024-03-01 08:45:48",08001107491-228099343,Innskudd
NOK,"Tilgjenglig for kjøp eller uttak",Uttak,-14.79,0,"2024-02-29 11:01:17",,"Obligatorisk udbetaling fra klientkonto"
NOK,"Tilgjenglig for kjøp eller uttak",Kjøp,-2000,14.79,"2024-02-28 21:19:03","G. Foss Eiendom AS - 4504",Tegning
NOK,"Tilgjenglig for kjøp eller uttak",Rente,14.79,2014.79,"2024-02-23 08:49:00","Lager For Alle AS - 4483",Renteinntekt
NOK,"Tilgjenglig for kjøp eller uttak",Innskudd,2000,2000,"2024-02-23 08:48:54",08023104611-228029343,Innskudd
NOK,"Tilgjenglig for kjøp eller uttak",Uttak,-2000,0,"2024-02-22 10:10:48",,"Obligatorisk udbetaling fra klientkonto"
NOK,"Tilgjenglig for kjøp eller uttak",Innskudd,2000,2000,"2024-02-20 09:16:22",08020105946-228099343,Innskudd
NOK,"Tilgjenglig for kjøp eller uttak",Kjøp,-2000,0,"2024-02-15 10:00:56","AEKO Eiendomsutvikling AS - 4501",Tegning
NOK,"Tilgjenglig for kjøp eller uttak",Innskudd,2000,2000,"2024-02-12 10:41:06",08012107498-228099343,Innskudd
NOK,"Tilgjenglig for kjøp eller uttak",Kjøp,-2000,0,"2024-01-26 15:18:51","BFM 8 AS - 4481",Tegning
NOK,"Tilgjenglig for kjøp eller uttak",Innskudd,2000,2000,"2024-01-26 08:32:03",08026104519-228059343,Innskudd
NOK,"Tilgjenglig for kjøp eller uttak",Kjøp,-2000,0,"2024-01-22 10:07:51","Lager For Alle AS - 4483",Tegning
NOK,"Tilgjenglig for kjøp eller uttak",Innskudd,2000,2000,"2024-01-22 09:52:56",08022108259-228019343,Innskudd
NOK,"Tilgjenglig for kjøp eller uttak",Uttak,-2000,0,"2024-01-18 11:05:37",,"Obligatorisk utbetaling av beløp på klientkonto"
NOK,"Tilgjenglig for kjøp eller uttak",Innskudd,2000,2000,"2024-01-17 16:18:14","Kvitsand Hytter AS - 4482","Overskytende beløp ved innskudd av tegnet beløp"
NOK,"Tilgjenglig for kjøp eller uttak",Kjøp,-2000,0,"2024-01-17 11:01:06","Kvitsand Hytter AS - 4482","Innskudd av tegnet beløp (fra tilgjengelig saldo)"
NOK,"Tilgjenglig for kjøp eller uttak",Innskudd,2000,2000,"2024-01-17 09:24:07",08017104575-228069343-D1,Innskudd
NOK,"Reservert beløp",Innskudd,207.28,500,"2025-08-05 14:30:56","Stubbbengkroken 73 AS - 4865","Innskudd av tegnet beløp"
NOK,"Reservert beløp",Kjøp,292.72,292.72,"2025-08-05 10:59:52","Stubbbengkroken 73 AS - 4865",Tegning
NOK,"Reservert beløp",Kjøp,-500,0,"2025-07-31 08:20:15","Stubbbengkroken 73 AS - 4846",Tildeling
NOK,"Reservert beløp",Kjøp,-9500,500,"2025-07-28 12:52:06","Palmeglass AS - 4848",Tildeling
NOK,"Reservert beløp",Innskudd,244.99,10000,"2025-07-22 18:18:05","Stubbbengkroken 73 AS - 4846","Innskudd av tegnet beløp"
NOK,"Reservert beløp",Kjøp,255.01,9755.01,"2025-07-22 12:55:54","Stubbbengkroken 73 AS - 4846",Tegning
NOK,"Reservert beløp",Kjøp,-500,9500,"2025-07-15 09:35:19","Konventveien 35 AS - 4713",Tildeling
NOK,"Reservert beløp",Kjøp,-500,10000,"2025-07-11 10:52:38","BFM 8 AS - 4844",Tildeling
NOK,"Reservert beløp",Innskudd,9453.04,10500,"2025-07-07 14:29:31","Palmeglass AS - 4848","Innskudd av tegnet beløp"
NOK,"Reservert beløp",Kjøp,46.96,1046.96,"2025-07-07 09:12:28","Palmeglass AS - 4848",Tegning
NOK,"Reservert beløp",Kjøp,0.13,1000,"2025-07-03 12:40:57","BFM 8 AS - 4844","Innskudd av tegnet beløp (fra tilgjengelig saldo)"
NOK,"Reservert beløp",Innskudd,455,999.87,"2025-07-01 14:05:45","BFM 8 AS - 4844","Innskudd av tegnet beløp"
NOK,"Reservert beløp",Kjøp,44.87,544.87,"2025-07-01 09:17:34","BFM 8 AS - 4844",Tegning
NOK,"Reservert beløp",Innskudd,178.04,500,"2025-06-30 08:39:37","Konventveien 35 AS - 4713","Innskudd av tegnet beløp"
NOK,"Reservert beløp",Kjøp,321.96,321.96,"2025-06-27 13:23:08","Konventveien 35 AS - 4713",Tegning
NOK,"Reservert beløp",Kjøp,-500,0,"2025-06-25 10:11:38","Atlas Eiendom AS - 4830",Tildeling
NOK,"Reservert beløp",Innskudd,287.9,500,"2025-06-11 14:48:46","Atlas Eiendom AS - 4830","Innskudd av tegnet beløp"
NOK,"Reservert beløp",Kjøp,212.1,212.1,"2025-06-11 09:48:19","Atlas Eiendom AS - 4830",Tegning
NOK,"Reservert beløp",Kjøp,-500,0,"2025-06-10 13:14:33","BFM 8 AS - 4826",Tildeling
NOK,"Reservert beløp",Kjøp,-500,500,"2025-06-04 12:11:10","VE Gruppen - 4820",Tildeling
NOK,"Reservert beløp",Innskudd,330.01,1000,"2025-05-28 15:31:14","BFM 8 AS - 4826","Innskudd av tegnet beløp"
NOK,"Reservert beløp",Kjøp,169.99,669.99,"2025-05-28 09:36:37","BFM 8 AS - 4826",Tegning
NOK,"Reservert beløp",Innskudd,196.72,500,"2025-05-26 14:05:55","VE Gruppen - 4820","Innskudd av tegnet beløp"
NOK,"Reservert beløp",Kjøp,303.28,303.28,"2025-05-26 09:18:54","VE Gruppen - 4820",Tegning
NOK,"Reservert beløp",Kjøp,-1000,0,"2025-05-16 08:27:18","BFM 8 AS - 4809",Tildeling
NOK,"Reservert beløp",Kjøp,1000,1000,"2025-05-08 13:15:36","BFM 8 AS - 4809",Tegning
NOK,"Reservert beløp",Kjøp,-1000,0,"2025-03-24 15:34:23","Palmeglass AS - 4760",Tildeling
NOK,"Reservert beløp",Innskudd,562.24,1000,"2025-03-14 09:25:40","Palmeglass AS - 4760","Innskudd av tegnet beløp"
NOK,"Reservert beløp",Kjøp,437.76,437.76,"2025-03-13 09:00:22","Palmeglass AS - 4760",Tegning
NOK,"Reservert beløp",Kjøp,-1000,0,"2025-02-27 12:39:43","Torggata 5 Skien AS - 4749",Tildeling
NOK,"Reservert beløp",Kjøp,-4000,1000,"2025-02-25 13:48:42","Palmeglass AS - 4730",Tildeling
NOK,"Reservert beløp",Kjøp,-1000,5000,"2025-02-24 14:45:17","TBGEiendom AS - 4742",Tildeling
NOK,"Reservert beløp",Innskudd,954.06,6000,"2025-02-19 15:15:34","Torggata 5 Skien AS - 4749","Innskudd av tegnet beløp"
NOK,"Reservert beløp",Kjøp,45.94,5045.94,"2025-02-19 09:32:58","Torggata 5 Skien AS - 4749",Tegning
NOK,"Reservert beløp",Kjøp,-1500,5000,"2025-02-13 12:25:22","Accrington AS  - 4726",Tildeling
NOK,"Reservert beløp",Innskudd,918.33,6500,"2025-02-12 15:54:01","TBGEiendom AS - 4742","Innskudd av tegnet beløp"
NOK,"Reservert beløp",Kjøp,81.67,5581.67,"2025-02-12 09:20:05","TBGEiendom AS - 4742",Tegning
NOK,"Reservert beløp",Innskudd,3921.66,5500,"2025-02-11 14:53:54","Palmeglass AS - 4730","Innskudd av tegnet beløp"
NOK,"Reservert beløp",Kjøp,-1500,1578.34,"2025-02-11 11:03:24","EFA Eiendom AS - 4711",Tildeling
NOK,"Reservert beløp",Kjøp,78.34,3078.34,"2025-02-11 09:00:25","Palmeglass AS - 4730",Tegning
NOK,"Reservert beløp",Kjøp,-1000,3000,"2025-02-05 11:40:15","Torggata 5 Skien AS - 4727",Tildeling
NOK,"Reservert beløp",Innskudd,1490,4000,"2025-02-05 08:33:22","Accrington AS  - 4726","Innskudd av tegnet beløp"
NOK,"Reservert beløp",Kjøp,10,2510,"2025-02-04 19:26:53","Accrington AS  - 4726",Tegning
NOK,"Reservert beløp",Kjøp,-1000,2500,"2025-01-31 10:59:52","Torggata 5 Skien AS - 4709",Tildeling
NOK,"Reservert beløp",Innskudd,1351.06,3500,"2025-01-31 09:04:25","EFA Eiendom AS - 4711","Innskudd av tegnet beløp"
NOK,"Reservert beløp",Kjøp,148.94,2148.94,"2025-01-30 12:59:20","EFA Eiendom AS - 4711",Tegning
NOK,"Reservert beløp",Kjøp,-2500,2000,"2025-01-30 10:46:01","Bjerget 33 Eiendom AS  - 4710",Tildeling
NOK,"Reservert beløp",Kjøp,-500,4500,"2025-01-28 14:09:47","BM Prosjekt og Utvikling AS - 4701",Tildeling
NOK,"Reservert beløp",Innskudd,955.83,5000,"2025-01-24 14:57:13","Torggata 5 Skien AS - 4727","Innskudd av tegnet beløp"
NOK,"Reservert beløp",Kjøp,44.17,4044.17,"2025-01-24 09:29:30","Torggata 5 Skien AS - 4727",Tegning
NOK,"Reservert beløp",Kjøp,-500,4000,"2025-01-22 11:23:37","Habitat Bolig AS - 4721",Tildeling
NOK,"Reservert beløp",Innskudd,1000,4500,"2025-01-17 14:32:46","Torggata 5 Skien AS - 4709","Innskudd av tegnet beløp"
NOK,"Reservert beløp",Innskudd,464.68,3500,"2025-01-15 14:17:01","BM Prosjekt og Utvikling AS - 4701","Innskudd av tegnet beløp"
NOK,"Reservert beløp",Kjøp,35.32,3035.32,"2025-01-15 09:01:55","BM Prosjekt og Utvikling AS - 4701",Tegning
NOK,"Reservert beløp",Innskudd,393.33,3000,"2025-01-10 14:23:15","Habitat Bolig AS - 4721","Innskudd av tegnet beløp"
NOK,"Reservert beløp",Kjøp,106.67,2606.67,"2025-01-10 09:38:11","Habitat Bolig AS - 4721",Tegning
NOK,"Reservert beløp",Kjøp,-500,2500,"2025-01-08 10:20:18","BM Prosjekt og Utvikling AS - 4691",Tildeling
NOK,"Reservert beløp",Innskudd,2248.32,3000,"2025-01-07 14:51:36","Bjerget 33 Eiendom AS  - 4710","Innskudd av tegnet beløp"
NOK,"Reservert beløp",Kjøp,251.68,751.68,"2025-01-07 09:00:25","Bjerget 33 Eiendom AS  - 4710",Tegning
NOK,"Reservert beløp",Kjøp,-2500,500,"2025-01-06 09:48:11","Habitat Bolig AS - 4702",Tildeling
NOK,"Reservert beløp",Innskudd,487.87,3000,"2024-12-20 17:06:33","BM Prosjekt og Utvikling AS - 4691","Innskudd av tegnet beløp"
NOK,"Reservert beløp",Kjøp,12.13,2512.13,"2024-12-20 09:05:44","BM Prosjekt og Utvikling AS - 4691",Tegning
NOK,"Reservert beløp",Innskudd,2195.97,2500,"2024-12-12 14:22:58","Habitat Bolig AS - 4702","Innskudd av tegnet beløp"
NOK,"Reservert beløp",Kjøp,304.03,304.03,"2024-12-12 09:00:59","Habitat Bolig AS - 4702",Tegning
NOK,"Reservert beløp",Kjøp,-500,0,"2024-12-09 14:42:37","Habitat Bolig AS - 4684",Tildeling
NOK,"Reservert beløp",Kjøp,-1000,500,"2024-12-02 13:09:08","TBGEiendom AS - 4683",Tildeling
NOK,"Reservert beløp",Innskudd,455.83,1500,"2024-11-26 09:04:55","Habitat Bolig AS - 4684","Innskudd av tegnet beløp"
NOK,"Reservert beløp",Kjøp,44.17,1044.17,"2024-11-25 23:00:40","Habitat Bolig AS - 4684",Tegning
NOK,"Reservert beløp",Innskudd,659.38,1000,"2024-11-20 15:20:38","TBGEiendom AS - 4683","Innskudd av tegnet beløp"
NOK,"Reservert beløp",Kjøp,340.62,340.62,"2024-11-20 09:06:17","TBGEiendom AS - 4683",Tegning
NOK,"Reservert beløp",Kjøp,-1000,0,"2024-11-18 13:43:47","Habitat Bolig AS - 4665",Tildeling
NOK,"Reservert beløp",Kjøp,-1000,1000,"2024-11-13 10:18:03","BFM 8 AS - 4671",Tildeling
NOK,"Reservert beløp",Kjøp,1000,2000,"2024-11-05 09:00:18","Habitat Bolig AS - 4665",Tegning
NOK,"Reservert beløp",Kjøp,1000,1000,"2024-10-30 09:14:12","BFM 8 AS - 4671",Tegning
NOK,"Reservert beløp",Kjøp,-500,0,"2024-10-25 13:18:10","Atlas Eiendom AS - 4659",Tildeling
NOK,"Reservert beløp",Kjøp,-500,500,"2024-10-23 12:40:28","BFM 8 AS - 4656",Tildeling
NOK,"Reservert beløp",Innskudd,500,1000,"2024-10-15 14:49:54","Atlas Eiendom AS - 4659","Innskudd av tegnet beløp"
NOK,"Reservert beløp",Innskudd,382.99,500,"2024-10-14 11:02:19","BFM 8 AS - 4656","Innskudd av tegnet beløp"
NOK,"Reservert beløp",Kjøp,117.01,117.01,"2024-10-11 14:01:49","BFM 8 AS - 4656",Tegning
NOK,"Reservert beløp",Kjøp,-1000,0,"2024-10-10 14:42:59","Thorrud Bolig AS - 4651",Tildeling
NOK,"Reservert beløp",Kjøp,-2000,1000,"2024-10-10 09:44:51","Accrington AS  - 4649",Tildeling
NOK,"Reservert beløp",Innskudd,908.34,3000,"2024-10-04 13:42:55","Thorrud Bolig AS - 4651","Innskudd av tegnet beløp"
NOK,"Reservert beløp",Kjøp,91.66,2091.66,"2024-10-03 14:20:32","Thorrud Bolig AS - 4651",Tegning
NOK,"Reservert beløp",Innskudd,1314.78,2000,"2024-09-30 08:43:16","Accrington AS  - 4649","Innskudd av tegnet beløp"
NOK,"Reservert beløp",Kjøp,685.22,685.22,"2024-09-27 14:00:29","Accrington AS  - 4649",Tegning
NOK,"Reservert beløp",Kjøp,-2500,0,"2024-09-27 10:28:43","BFM 8 AS - 4644",Tildeling
NOK,"Reservert beløp",Kjøp,-500,2500,"2024-09-26 12:27:23","Atlas Eiendom AS - 4637",Tildeling
NOK,"Reservert beløp",Innskudd,39.81,3000,"2024-09-18 08:58:59","Atlas Eiendom AS - 4637","Innskudd av tegnet beløp"
NOK,"Reservert beløp",Kjøp,460.19,2960.19,"2024-09-17 14:12:27","Atlas Eiendom AS - 4637",Tegning
NOK,"Reservert beløp",Kjøp,2500,2500,"2024-09-13 14:00:21","BFM 8 AS - 4644",Tegning
NOK,"Reservert beløp",Kjøp,-2000,0,"2024-09-04 11:11:53","EFA Eiendom AS - 4628",Tildeling
NOK,"Reservert beløp",Kjøp,2000,2000,"2024-08-21 14:34:00","EFA Eiendom AS - 4628",Tegning
NOK,"Reservert beløp",Kjøp,-2000,0,"2024-08-01 09:41:22","Quadrat Eiendom AS - 4566",Tildeling
NOK,"Reservert beløp",Kjøp,-2000,2000,"2024-07-09 09:53:08","EBH Entreprenør AS - 4599",Tildeling
NOK,"Reservert beløp",Innskudd,2000,4000,"2024-07-08 08:16:19","Quadrat Eiendom AS - 4566","Innskudd av tegnet beløp"
NOK,"Reservert beløp",Kjøp,-2000,2000,"2024-07-01 12:44:00","LeilighetsExperten AS - 4592",Tildeling
NOK,"Reservert beløp",Innskudd,2000,4000,"2024-06-28 14:21:59","EBH Entreprenør AS - 4599","Innskudd av tegnet beløp"
NOK,"Reservert beløp",Innskudd,2000,2000,"2024-06-18 08:02:46","LeilighetsExperten AS - 4592","Innskudd av tegnet beløp"
NOK,"Reservert beløp",Uttak,-240.25,0,"2024-06-06 15:35:37",C60199-2259,"Obligatorisk utbetaling fullført"
NOK,"Reservert beløp",Uttak,240.25,240.25,"2024-06-06 10:40:24",,"Obligatorisk utbetaling av beløp på klientkonto"
NOK,"Reservert beløp",Uttak,-186.67,0,"2024-05-02 15:21:43",C29407-2261,"Obligatorisk utbetaling fullført"
NOK,"Reservert beløp",Kjøp,-2000,186.67,"2024-05-02 14:11:01","Streng AS - 4537",Tildeling
NOK,"Reservert beløp",Uttak,186.67,2186.67,"2024-05-02 11:17:50",,"Obligatorisk utbetaling av beløp på klientkonto"
NOK,"Reservert beløp",Kjøp,-2000,2000,"2024-04-23 10:22:00","Atlas Eiendom AS - 4541",Tildeling
NOK,"Reservert beløp",Kjøp,2000,4000,"2024-04-17 10:32:45","Streng AS - 4537",Tegning
NOK,"Reservert beløp",Kjøp,2000,2000,"2024-04-10 10:00:49","Atlas Eiendom AS - 4541",Tegning
NOK,"Reservert beløp",Kjøp,-2000,0,"2024-04-08 16:59:21","Atlas Eiendom AS - 4526",Tildeling
NOK,"Reservert beløp",Uttak,-2121.67,2000,"2024-04-04 16:39:34",N13536-2266,"Obligatorisk utbetalning genomförd"
NOK,"Reservert beløp",Uttak,2121.67,4121.67,"2024-04-04 10:20:33",,"Obligatorisk udbetaling fra klientkonto"
NOK,"Reservert beløp",Kjøp,-2000,2000,"2024-04-02 13:21:37","EFA Eiendom AS - 4451",Tildeling
NOK,"Reservert beløp",Kjøp,2000,4000,"2024-03-25 13:00:18","Atlas Eiendom AS - 4526",Tegning
NOK,"Reservert beløp",Kjøp,-2000,2000,"2024-03-22 13:40:12","Kvitsand Hytter AS - 4516",Tildeling
NOK,"Reservert beløp",Uttak,-2000,4000,"2024-03-21 15:38:31",E03129-1050,"Obligatorisk utbetalning genomförd"
NOK,"Reservert beløp",Uttak,2000,6000,"2024-03-21 10:42:14",,"Obligatorisk utbetalning av belopp på klientmedelskonto"
NOK,"Reservert beløp",Kjøp,-2000,4000,"2024-03-15 15:19:58","Atlas Eiendom AS - 4510",Tildeling
NOK,"Reservert beløp",Uttak,-54.89,6000,"2024-03-14 15:31:10",A50688-853,"Obligatorisk utbetalning genomförd"
NOK,"Reservert beløp",Uttak,54.89,6054.89,"2024-03-14 10:08:38",,"Obligatorisk udbetaling fra klientkonto"
NOK,"Reservert beløp",Kjøp,2000,6000,"2024-03-08 14:03:18","EFA Eiendom AS - 4451",Tegning
NOK,"Reservert beløp",Kjøp,-2000,4000,"2024-03-07 10:53:25","G. Foss Eiendom AS - 4504",Tildeling
NOK,"Reservert beløp",Kjøp,2000,6000,"2024-03-06 14:14:36","Kvitsand Hytter AS - 4516",Tegning
NOK,"Reservert beløp",Kjøp,2000,4000,"2024-03-01 14:00:23","Atlas Eiendom AS - 4510",Tegning
NOK,"Reservert beløp",Uttak,-14.79,2000,"2024-02-29 15:49:31",A63649-2203,"Obligatorisk utbetalning genomförd"
NOK,"Reservert beløp",Uttak,14.79,2014.79,"2024-02-29 11:01:17",,"Obligatorisk udbetaling fra klientkonto"
NOK,"Reservert beløp",Kjøp,2000,2000,"2024-02-28 21:19:03","G. Foss Eiendom AS - 4504",Tegning
NOK,"Reservert beløp",Kjøp,-2000,0,"2024-02-26 17:06:30","AEKO Eiendomsutvikling AS - 4501",Tildeling
NOK,"Reservert beløp",Uttak,-2000,2000,"2024-02-22 15:30:26",C58120-987,"Obligatorisk udbetaling gennemført"
NOK,"Reservert beløp",Uttak,2000,4000,"2024-02-22 10:10:48",,"Obligatorisk udbetaling fra klientkonto"
NOK,"Reservert beløp",Kjøp,2000,2000,"2024-02-15 10:00:56","AEKO Eiendomsutvikling AS - 4501",Tegning
NOK,"Reservert beløp",Kjøp,-2000,0,"2024-02-12 10:08:00","Kvitsand Hytter AS - 4482",Tildeling
NOK,"Reservert beløp",Kjøp,-2000,2000,"2024-02-09 14:20:39","BFM 8 AS - 4481",Tildeling
NOK,"Reservert beløp",Kjøp,-2000,4000,"2024-02-06 12:48:44","Lager For Alle AS - 4483",Tildeling
NOK,"Reservert beløp",Kjøp,2000,6000,"2024-01-26 15:18:51","BFM 8 AS - 4481",Tegning
NOK,"Reservert beløp",Kjøp,2000,4000,"2024-01-22 10:07:51","Lager For Alle AS - 4483",Tegning
NOK,"Reservert beløp",Uttak,-2000,2000,"2024-01-18 15:38:09",I03476-1331,"Obligatorisk utbetalning genomförd"
NOK,"Reservert beløp",Uttak,2000,4000,"2024-01-18 11:05:37",,"Obligatorisk utbetaling av beløp på klientkonto"
NOK,"Reservert beløp",Kjøp,2000,2000,"2024-01-17 11:01:06","Kvitsand Hytter AS - 4482","Innskudd av tegnet beløp (fra tilgjengelig saldo)"
NOK,Betalingsforpliktelser,Innskudd,207.28,0,"2025-08-05 14:30:56","Stubbbengkroken 73 AS - 4865","Innskudd av tegnet beløp"
NOK,Betalingsforpliktelser,Kjøp,-207.28,-207.28,"2025-08-05 10:59:52","Stubbbengkroken 73 AS - 4865","Ubetalt tegning"
NOK,Betalingsforpliktelser,Innskudd,244.99,0,"2025-07-22 18:18:05","Stubbbengkroken 73 AS - 4846","Innskudd av tegnet beløp"
NOK,Betalingsforpliktelser,Kjøp,-244.99,-244.99,"2025-07-22 12:55:54","Stubbbengkroken 73 AS - 4846","Ubetalt tegning"
NOK,Betalingsforpliktelser,Innskudd,9453.04,0,"2025-07-07 14:29:31","Palmeglass AS - 4848","Innskudd av tegnet beløp"
NOK,Betalingsforpliktelser,Kjøp,-9453.04,-9453.04,"2025-07-07 09:12:28","Palmeglass AS - 4848","Ubetalt tegning"
NOK,Betalingsforpliktelser,Kjøp,0.13,0,"2025-07-03 12:40:57","BFM 8 AS - 4844","Innskudd av tegnet beløp (fra tilgjengelig saldo)"
NOK,Betalingsforpliktelser,Innskudd,455,-0.13,"2025-07-01 14:05:45","BFM 8 AS - 4844","Innskudd av tegnet beløp"
NOK,Betalingsforpliktelser,Kjøp,-455.13,-455.13,"2025-07-01 09:17:34","BFM 8 AS - 4844","Ubetalt tegning"
NOK,Betalingsforpliktelser,Innskudd,178.04,0,"2025-06-30 08:39:37","Konventveien 35 AS - 4713","Innskudd av tegnet beløp"
NOK,Betalingsforpliktelser,Kjøp,-178.04,-178.04,"2025-06-27 13:23:08","Konventveien 35 AS - 4713","Ubetalt tegning"
NOK,Betalingsforpliktelser,Innskudd,287.9,0,"2025-06-11 14:48:46","Atlas Eiendom AS - 4830","Innskudd av tegnet beløp"
NOK,Betalingsforpliktelser,Kjøp,-287.9,-287.9,"2025-06-11 09:48:18","Atlas Eiendom AS - 4830","Ubetalt tegning"
NOK,Betalingsforpliktelser,Innskudd,330.01,0,"2025-05-28 15:31:14","BFM 8 AS - 4826","Innskudd av tegnet beløp"
NOK,Betalingsforpliktelser,Kjøp,-330.01,-330.01,"2025-05-28 09:36:37","BFM 8 AS - 4826","Ubetalt tegning"
NOK,Betalingsforpliktelser,Innskudd,196.72,0,"2025-05-26 14:05:55","VE Gruppen - 4820","Innskudd av tegnet beløp"
NOK,Betalingsforpliktelser,Kjøp,-196.72,-196.72,"2025-05-26 09:18:54","VE Gruppen - 4820","Ubetalt tegning"
NOK,Betalingsforpliktelser,Innskudd,562.24,0,"2025-03-14 09:25:40","Palmeglass AS - 4760","Innskudd av tegnet beløp"
NOK,Betalingsforpliktelser,Kjøp,-562.24,-562.24,"2025-03-13 09:00:22","Palmeglass AS - 4760","Ubetalt tegning"
NOK,Betalingsforpliktelser,Innskudd,954.06,0,"2025-02-19 15:15:34","Torggata 5 Skien AS - 4749","Innskudd av tegnet beløp"
NOK,Betalingsforpliktelser,Kjøp,-954.06,-954.06,"2025-02-19 09:32:58","Torggata 5 Skien AS - 4749","Ubetalt tegning"
NOK,Betalingsforpliktelser,Innskudd,918.33,0,"2025-02-12 15:54:01","TBGEiendom AS - 4742","Innskudd av tegnet beløp"
NOK,Betalingsforpliktelser,Kjøp,-918.33,-918.33,"2025-02-12 09:20:05","TBGEiendom AS - 4742","Ubetalt tegning"
NOK,Betalingsforpliktelser,Innskudd,3921.66,0,"2025-02-11 14:53:54","Palmeglass AS - 4730","Innskudd av tegnet beløp"
NOK,Betalingsforpliktelser,Kjøp,-3921.66,-3921.66,"2025-02-11 09:00:25","Palmeglass AS - 4730","Ubetalt tegning"
NOK,Betalingsforpliktelser,Innskudd,1490,0,"2025-02-05 08:33:22","Accrington AS  - 4726","Innskudd av tegnet beløp"
NOK,Betalingsforpliktelser,Kjøp,-1490,-1490,"2025-02-04 19:26:53","Accrington AS  - 4726","Ubetalt tegning"
NOK,Betalingsforpliktelser,Innskudd,1351.06,0,"2025-01-31 09:04:25","EFA Eiendom AS - 4711","Innskudd av tegnet beløp"
NOK,Betalingsforpliktelser,Kjøp,-1351.06,-1351.06,"2025-01-30 12:59:20","EFA Eiendom AS - 4711","Ubetalt tegning"
NOK,Betalingsforpliktelser,Innskudd,955.83,0,"2025-01-24 14:57:13","Torggata 5 Skien AS - 4727","Innskudd av tegnet beløp"
NOK,Betalingsforpliktelser,Kjøp,-955.83,-955.83,"2025-01-24 09:29:30","Torggata 5 Skien AS - 4727","Ubetalt tegning"
NOK,Betalingsforpliktelser,Innskudd,1000,0,"2025-01-17 14:32:46","Torggata 5 Skien AS - 4709","Innskudd av tegnet beløp"
NOK,Betalingsforpliktelser,Kjøp,-1000,-1000,"2025-01-17 09:00:42","Torggata 5 Skien AS - 4709","Ubetalt tegning"
NOK,Betalingsforpliktelser,Innskudd,464.68,0,"2025-01-15 14:17:01","BM Prosjekt og Utvikling AS - 4701","Innskudd av tegnet beløp"
NOK,Betalingsforpliktelser,Kjøp,-464.68,-464.68,"2025-01-15 09:01:55","BM Prosjekt og Utvikling AS - 4701","Ubetalt tegning"
NOK,Betalingsforpliktelser,Innskudd,393.33,0,"2025-01-10 14:23:15","Habitat Bolig AS - 4721","Innskudd av tegnet beløp"
NOK,Betalingsforpliktelser,Kjøp,-393.33,-393.33,"2025-01-10 09:38:11","Habitat Bolig AS - 4721","Ubetalt tegning"
NOK,Betalingsforpliktelser,Innskudd,2248.32,0,"2025-01-07 14:51:36","Bjerget 33 Eiendom AS  - 4710","Innskudd av tegnet beløp"
NOK,Betalingsforpliktelser,Kjøp,-2248.32,-2248.32,"2025-01-07 09:00:25","Bjerget 33 Eiendom AS  - 4710","Ubetalt tegning"
NOK,Betalingsforpliktelser,Innskudd,487.87,0,"2024-12-20 17:06:33","BM Prosjekt og Utvikling AS - 4691","Innskudd av tegnet beløp"
NOK,Betalingsforpliktelser,Kjøp,-487.87,-487.87,"2024-12-20 09:05:44","BM Prosjekt og Utvikling AS - 4691","Ubetalt tegning"
NOK,Betalingsforpliktelser,Innskudd,2195.97,0,"2024-12-12 14:22:58","Habitat Bolig AS - 4702","Innskudd av tegnet beløp"
NOK,Betalingsforpliktelser,Kjøp,-2195.97,-2195.97,"2024-12-12 09:00:59","Habitat Bolig AS - 4702","Ubetalt tegning"
NOK,Betalingsforpliktelser,Innskudd,455.83,0,"2024-11-26 09:04:55","Habitat Bolig AS - 4684","Innskudd av tegnet beløp"
NOK,Betalingsforpliktelser,Kjøp,-455.83,-455.83,"2024-11-25 23:00:40","Habitat Bolig AS - 4684","Ubetalt tegning"
NOK,Betalingsforpliktelser,Innskudd,659.38,0,"2024-11-20 15:20:38","TBGEiendom AS - 4683","Innskudd av tegnet beløp"
NOK,Betalingsforpliktelser,Kjøp,-659.38,-659.38,"2024-11-20 09:06:17","TBGEiendom AS - 4683","Ubetalt tegning"
NOK,Betalingsforpliktelser,Innskudd,500,0,"2024-10-15 14:49:54","Atlas Eiendom AS - 4659","Innskudd av tegnet beløp"
NOK,Betalingsforpliktelser,Kjøp,-500,-500,"2024-10-15 09:28:42","Atlas Eiendom AS - 4659","Ubetalt tegning"
NOK,Betalingsforpliktelser,Innskudd,382.99,0,"2024-10-14 11:02:19","BFM 8 AS - 4656","Innskudd av tegnet beløp"
NOK,Betalingsforpliktelser,Kjøp,-382.99,-382.99,"2024-10-11 14:01:49","BFM 8 AS - 4656","Ubetalt tegning"
NOK,Betalingsforpliktelser,Innskudd,908.34,0,"2024-10-04 13:42:55","Thorrud Bolig AS - 4651","Innskudd av tegnet beløp"
NOK,Betalingsforpliktelser,Kjøp,-908.34,-908.34,"2024-10-03 14:20:32","Thorrud Bolig AS - 4651","Ubetalt tegning"
NOK,Betalingsforpliktelser,Innskudd,1314.78,0,"2024-09-30 08:43:16","Accrington AS  - 4649","Innskudd av tegnet beløp"
NOK,Betalingsforpliktelser,Kjøp,-1314.78,-1314.78,"2024-09-27 14:00:29","Accrington AS  - 4649","Ubetalt tegning"
NOK,Betalingsforpliktelser,Innskudd,39.81,0,"2024-09-18 08:58:59","Atlas Eiendom AS - 4637","Innskudd av tegnet beløp"
NOK,Betalingsforpliktelser,Kjøp,-39.81,-39.81,"2024-09-17 14:12:27","Atlas Eiendom AS - 4637","Ubetalt tegning"
NOK,Betalingsforpliktelser,Innskudd,2000,0,"2024-07-08 08:16:19","Quadrat Eiendom AS - 4566","Innskudd av tegnet beløp"
NOK,Betalingsforpliktelser,Kjøp,-2000,-2000,"2024-07-05 13:43:34","Quadrat Eiendom AS - 4566","Ubetalt tegning"
NOK,Betalingsforpliktelser,Innskudd,2000,0,"2024-06-28 14:21:59","EBH Entreprenør AS - 4599","Innskudd av tegnet beløp"
NOK,Betalingsforpliktelser,Kjøp,-2000,-2000,"2024-06-28 10:00:17","EBH Entreprenør AS - 4599","Ubetalt tegning"
NOK,Betalingsforpliktelser,Innskudd,2000,0,"2024-06-18 08:02:46","LeilighetsExperten AS - 4592","Innskudd av tegnet beløp"
NOK,Betalingsforpliktelser,Kjøp,-2000,-2000,"2024-06-17 14:17:38","LeilighetsExperten AS - 4592","Ubetalt tegning"
NOK,Betalingsforpliktelser,Kjøp,2000,0,"2024-01-17 11:01:06","Kvitsand Hytter AS - 4482","Innskudd av tegnet beløp (fra tilgjengelig saldo)"
NOK,Betalingsforpliktelser,Kjøp,-2000,-2000,"2024-01-16 20:43:30","Kvitsand Hytter AS - 4482","Ubetalt tegning"
